"duration","codec","width","height","bitrate","framerate","i","p","b","frames","i_size","p_size","size","o_bitrate","o_framerate","o_width","o_height","umem","utime"
273.816,"vp8",1920,1080,1571003,25.065933,77,6766,0,6843,6190779,47579961,53770740,3000000,29.97,1280,720,219656,7.428
225.08,"h264",480,360,538452,25,113,5515,0,5628,1873408,13275961,15149369,3000000,24,176,144,216820,0.952
59.883,"vp8",1280,720,994960,30.38983,13,1780,0,1793,481774,6965881,7447655,56000,29.97,480,360,155028,6.436
254.922,"vp8",480,360,260667,30.062992,51,7585,0,7636,918325,7387906,8306231,109000,29.97,320,240,221160,1.1
255.28,"flv",320,240,250276,25,110,6272,0,6382,611474,7374864,7986338,3000000,24,480,360,216820,1.02
379.32,"h264",480,360,181960,25,195,9289,0,9484,3392479,5235193,8627672,242000,24,480,360,219464,2.8
225.08,"h264",480,360,538452,25,113,5515,0,5628,1873408,13275961,15149369,3000000,15,176,144,216820,1.68
42.2,"h264",480,360,288705,25,23,1033,0,1056,216154,1306770,1522924,242000,12,480,360,216820,0.744
340.424,"flv",320,240,244491,11,69,4012,0,4081,1168939,9234909,10403848,539000,15,1920,1080,221152,20.837
384.451,"h264",640,480,646432,29,205,11318,0,11523,2839955,28225248,31065203,820000,15,320,240,217828,1.64
1140.349,"vp8",1280,720,2394626,30.007017,328,33880,0,34208,20478926,320859863,341338789,56000,29.97,320,240,219480,8.073
1140.349,"vp8",1280,720,2394626,30.007017,328,33880,0,34208,20478926,320859863,341338789,3000000,24,320,240,219480,10.297
217.518,"h264",480,360,83054,29,112,6408,0,6520,406683,1851539,2258222,109000,29.97,640,480,217080,5.68
339.667,"h264",640,480,257699,30,181,10010,0,10191,10121223,820261,10941484,3000000,15,176,144,219480,1.656
106.765,"h264",1280,720,849586,25,66,2603,0,2669,4427240,6911026,11338266,5000000,15,320,240,219480,2.556
714.371,"vp8",1280,720,652356,29.981792,143,21264,0,21407,14532530,43720516,58253046,109000,29.97,320,240,165204,3.08
316.95166,"mpeg4",176,144,55396,12,64,3739,0,3803,111850,2082902,2194752,242000,25,640,480,165700,0.652
63.667,"h264",640,480,972572,15,33,923,0,956,1259657,6480438,7740095,5000000,25,176,144,219656,2.908
906.5983,"mpeg4",176,144,56108,12,187,10692,0,10879,597549,5760936,6358485,539000,29.97,640,480,165668,3.38
107.443,"vp8",480,360,320011,30.093458,30,3190,0,3220,671936,3625932,4297868,56000,24,480,360,216820,6.008
86.486,"h264",640,480,356037,29,46,2547,0,2593,819680,3029350,3849030,539000,25,640,480,219656,6.38
216.55,"h264",320,240,291150,29,112,6379,0,6491,1789334,6091735,7881069,242000,15,480,360,212336,5.564
458.625,"h264",640,480,517364,29,245,13501,0,13746,5308581,24350943,29659524,242000,24,320,240,216820,2.704
37.011665,"h264",1280,720,2759449,29,21,1088,0,1109,1899633,10866846,12766479,5000000,25,1280,720,334860,91.37
270.655,"vp8",640,480,652967,30.062963,89,8028,0,8117,1912240,20178890,22091130,109000,25,480,360,219480,3.42
157.891,"h264",480,360,406908,29,87,4646,0,4733,1776729,6254165,8030894,820000,24,640,480,219464,5.056
110.966995,"h264",480,360,397112,30,59,3271,0,3330,529627,4978664,5508291,820000,29.97,640,480,216820,28.05
127.221664,"h264",1920,1080,3080852,23,70,2980,0,3050,3818903,45174992,48993895,5000000,29.97,480,360,217544,34.69
67.583336,"mpeg4",176,144,51225,12,15,777,0,792,47585,385164,432749,109000,15,1280,720,219480,3.792
39.055,"h264",1920,1080,5992818,30,26,1144,0,1170,839251,28416939,29256190,820000,29.97,176,144,216020,15.633
384.451,"h264",640,480,646432,29,205,11318,0,11523,2839955,28225248,31065203,56000,12,480,360,217828,1.612
906.5983,"mpeg4",176,144,56108,12,187,10692,0,10879,597549,5760936,6358485,242000,25,176,144,165668,0.296
167.39166,"h264",1280,720,2207484,24,86,3931,0,4017,4369420,41819887,46189307,5000000,25,176,144,219656,4.912
189.956,"flv",320,240,231296,29,97,5597,0,5694,580292,4911734,5492026,242000,24,176,144,218664,0.444
581.233,"h264",480,360,295979,30,310,17128,0,17438,10151572,11352574,21504146,109000,24,1920,1080,218932,5.536
340.424,"flv",320,240,244491,11,69,4012,0,4081,1168939,9234909,10403848,242000,12,480,360,221152,0.512
64.933,"flv",320,240,236793,15,39,936,0,975,318954,1603007,1921961,109000,15,480,360,217080,3.64
1768.9417,"mpeg4",176,144,56152,12,354,20873,0,21227,1382103,11034284,12416387,820000,29.97,1920,1080,234964,3.104
458.625,"h264",640,480,517364,29,245,13501,0,13746,5308581,24350943,29659524,5000000,12,320,240,216820,1.784
143.03334,"mpeg4",176,144,51082,12,31,1685,0,1716,56405,856907,913312,5000000,12,640,480,219480,2.14
39.055,"h264",1920,1080,5992818,30,26,1144,0,1170,839251,28416939,29256190,5000000,25,1280,720,377188,120.524
256.20834,"mpeg4",176,144,57565,12,56,3018,0,3074,302900,1540700,1843600,5000000,29.97,1920,1080,219480,16.593
473,"h264",320,240,164017,25,198,10924,704,11826,1419320,8047423,9697521,242000,15,480,360,220900,1
476.957,"vp8",1280,720,1387100,30.05252,105,14200,0,14305,3487520,79210885,82698405,539000,29.97,1920,1080,165700,39.27
860.056,"vp8",1280,720,2688309,29.968605,277,25496,0,25773,12989828,276022270,289012098,5000000,24,320,240,260708,4.788
476.957,"vp8",1280,720,1387100,30.05252,105,14200,0,14305,3487520,79210885,82698405,5000000,15,1920,1080,165696,10.629
33.09,"h264",320,240,279173,13,22,434,0,456,101794,1052937,1154731,109000,12,480,360,219480,5.196
860.056,"vp8",1280,720,2688309,29.968605,277,25496,0,25773,12989828,276022270,289012098,109000,15,320,240,257504,4.524
86.486,"h264",640,480,356037,29,46,2547,0,2593,819680,3029350,3849030,5000000,12,640,480,219656,3.696
286.995,"h264",480,360,508160,23,156,6726,0,6882,2285153,15944803,18229956,242000,15,1920,1080,216820,26.918
77.233,"h264",480,360,382461,30,53,2265,0,2318,182297,3510033,3692330,109000,15,1920,1080,219480,8.361
37.011665,"h264",1280,720,2759449,29,21,1088,0,1109,1899633,10866846,12766479,109000,24,640,480,219480,16.557
440.967,"h264",320,240,281642,30,236,12994,0,13230,2444863,13079542,15524405,56000,24,1920,1080,219656,11.789
63.667,"h264",640,480,972572,15,33,923,0,956,1259657,6480438,7740095,820000,25,176,144,219656,2.036
340.424,"flv",320,240,244491,11,69,4012,0,4081,1168939,9234909,10403848,539000,12,320,240,221152,1.776
131.76,"vp8",640,480,104723,25.145039,37,3257,0,3294,945865,778937,1724802,820000,29.97,1920,1080,221152,4.82
384.451,"h264",640,480,646432,29,205,11318,0,11523,2839955,28225248,31065203,242000,24,640,480,217544,4.304
176.901,"vp8",480,360,26968,25.113636,38,4382,0,4420,393395,202954,596349,820000,12,640,480,218932,2.416
395.44,"vp8",1280,720,1611942,25.027847,80,9806,0,9886,5073258,74605061,79678319,820000,29.97,1920,1080,658956,56.892
130.35667,"mpeg4",176,144,54590,12,27,1537,0,1564,64483,825054,889537,109000,24,176,144,38644,1.304
290.01666,"mpeg4",176,144,52783,12,61,3417,0,3478,119325,1794184,1913509,820000,15,176,144,128624,0.692
860.056,"vp8",1280,720,2688309,29.968605,277,25496,0,25773,12989828,276022270,289012098,820000,29.97,1280,720,262592,39.746
131.76,"vp8",640,480,104723,25.145039,37,3257,0,3294,945865,778937,1724802,3000000,15,480,360,221152,1.024
64.933,"flv",320,240,236793,15,39,936,0,975,318954,1603007,1921961,242000,15,320,240,217080,0.412
203.198,"flv",320,240,239336,29,104,5974,0,6078,853613,5225468,6079081,5000000,12,176,144,221160,0.448
33.09,"h264",320,240,279173,13,22,434,0,456,101794,1052937,1154731,5000000,12,640,480,219480,7.4
98.683334,"mpeg4",176,144,55552,12,20,1164,0,1184,48267,636993,685260,242000,15,480,360,218136,3.576
255.28,"flv",320,240,250276,25,110,6272,0,6382,611474,7374864,7986338,56000,25,640,480,216820,1.04
110.966995,"h264",480,360,397112,30,59,3271,0,3330,529627,4978664,5508291,109000,12,176,144,216820,1.016
490.6,"h264",480,360,300437,25,256,12010,0,12266,1448177,16976151,18424328,539000,12,480,360,219480,0.956
440.967,"h264",320,240,281642,30,236,12994,0,13230,2444863,13079542,15524405,820000,12,640,480,219656,3.7
458.625,"h264",640,480,517364,29,245,13501,0,13746,5308581,24350943,29659524,109000,29.97,176,144,216820,2.096
203.198,"flv",320,240,239336,29,104,5974,0,6078,853613,5225468,6079081,5000000,15,1920,1080,612440,105.427
379.32,"h264",480,360,181960,25,195,9289,0,9484,3392479,5235193,8627672,5000000,24,320,240,219464,2.656
379.32,"h264",480,360,181960,25,195,9289,0,9484,3392479,5235193,8627672,5000000,25,1280,720,325248,38.466
77.233,"h264",480,360,382461,30,53,2265,0,2318,182297,3510033,3692330,5000000,12,640,480,219480,1.5
490.6,"h264",480,360,300437,25,256,12010,0,12266,1448177,16976151,18424328,3000000,24,640,480,219480,5.772
52.68,"h264",480,360,372001,25,53,1265,0,1318,870136,1579497,2449633,5000000,12,480,360,140080,3.412
239.14166,"h264",480,360,500198,25,110,5868,0,5978,1406751,13545526,14952277,5000000,12,1920,1080,106148,29.706
67.583336,"mpeg4",176,144,51225,12,15,777,0,792,47585,385164,432749,56000,12,1920,1080,219480,2.42
645.84,"vp8",320,240,95903,25.032558,138,16008,0,16146,1081321,6660941,7742262,242000,29.97,480,360,218932,3.636
189.956,"flv",320,240,231296,29,97,5597,0,5694,580292,4911734,5492026,109000,29.97,176,144,218192,1.576
59.883,"vp8",1280,720,994960,30.38983,13,1780,0,1793,481774,6965881,7447655,242000,24,1920,1080,155028,30.226
157.891,"h264",480,360,406908,29,87,4646,0,4733,1776729,6254165,8030894,539000,24,640,480,219464,8.293
222.53334,"h264",480,360,500449,30,219,6457,0,6676,2821722,11099102,13920824,5000000,24,640,480,217336,4.224
273.816,"vp8",1920,1080,1571003,25.065933,77,6766,0,6843,6190779,47579961,53770740,242000,29.97,480,360,219656,5.356
750.433,"vp8",1280,720,794075,13.482667,81,10031,0,10112,3852576,70635013,74487589,242000,24,1280,720,165700,7.688
204.938,"h264",480,360,297373,16,111,3169,0,3280,1451634,6166260,7617894,56000,29.97,1280,720,77616,9.425
49.178333,"mpeg4",176,144,54338,7,10,334,0,344,33046,300986,334032,5000000,15,480,360,221160,0.396
750.433,"vp8",1280,720,794075,13.482667,81,10031,0,10112,3852576,70635013,74487589,820000,24,1920,1080,165700,11.261
395.44,"vp8",1280,720,1611942,25.027847,80,9806,0,9886,5073258,74605061,79678319,820000,24,320,240,221160,5.468
176.901,"vp8",480,360,26968,25.113636,38,4382,0,4420,393395,202954,596349,820000,25,1280,720,218932,6.952
39.055,"h264",1920,1080,5992818,30,26,1144,0,1170,839251,28416939,29256190,5000000,29.97,320,240,215848,10.093
254.922,"vp8",480,360,260667,30.062992,51,7585,0,7636,918325,7387906,8306231,5000000,15,1280,720,221160,15.693
157.891,"h264",480,360,406908,29,87,4646,0,4733,1776729,6254165,8030894,109000,29.97,1280,720,219464,20.117
254.922,"vp8",480,360,260667,30.062992,51,7585,0,7636,918325,7387906,8306231,5000000,24,640,480,221160,1.772
326.583,"vp8",640,480,1055982,25.039877,102,8061,0,8163,1868804,41239444,43108248,539000,12,640,480,212772,6.432
42.2,"h264",480,360,288705,25,23,1033,0,1056,216154,1306770,1522924,3000000,24,640,480,216820,1.388
391.08,"h264",640,480,230847,25,209,9569,0,9778,9023743,2261252,11284995,3000000,24,640,480,219480,1.204
42.2,"h264",480,360,288705,25,23,1033,0,1056,216154,1306770,1522924,56000,15,320,240,216820,2.192
476.957,"vp8",1280,720,1387100,30.05252,105,14200,0,14305,3487520,79210885,82698405,539000,24,640,480,165700,3.404
282.56,"h264",640,480,559834,25,145,6920,0,7065,4966509,14806840,19773349,242000,29.97,176,144,221152,2.012
274.541,"vp8",480,360,139791,30.029198,58,8170,0,8228,802625,3994697,4797322,820000,29.97,176,144,216064,2.616
1768.9417,"mpeg4",176,144,56152,12,354,20873,0,21227,1382103,11034284,12416387,539000,12,480,360,231780,0.612
326.58832,"h264",1920,1080,5999648,23,174,7656,0,7830,16603953,228322925,244926878,56000,29.97,640,480,218932,19.397
52.68,"h264",480,360,372001,25,53,1265,0,1318,870136,1579497,2449633,5000000,29.97,320,240,155028,15.757
395.44,"vp8",1280,720,1611942,25.027847,80,9806,0,9886,5073258,74605061,79678319,56000,12,640,480,221160,1.672
473,"h264",320,240,164017,25,198,10924,704,11826,1419320,8047423,9697521,539000,25,640,480,220900,8.909
110.966995,"h264",480,360,397112,30,59,3271,0,3330,529627,4978664,5508291,56000,15,1280,720,216820,2.536
204.938,"h264",480,360,297373,16,111,3169,0,3280,1451634,6166260,7617894,5000000,12,176,144,93552,1.88
39.055,"h264",1920,1080,5992818,30,26,1144,0,1170,839251,28416939,29256190,5000000,12,480,360,215848,10.141
440.967,"h264",320,240,281642,30,236,12994,0,13230,2444863,13079542,15524405,56000,12,320,240,219656,0.608
304.927,"vp8",320,240,134334,25.075659,82,7541,0,7623,833754,4286526,5120280,3000000,24,176,144,216820,1.768
256.20834,"mpeg4",176,144,57565,12,56,3018,0,3074,302900,1540700,1843600,3000000,25,1280,720,219480,6.588
64.933,"flv",320,240,236793,15,39,936,0,975,318954,1603007,1921961,242000,29.97,640,480,217080,5.804
581.233,"h264",480,360,295979,30,310,17128,0,17438,10151572,11352574,21504146,56000,25,1280,720,322844,16.541
52.68,"h264",480,360,372001,25,53,1265,0,1318,870136,1579497,2449633,5000000,15,640,480,155028,30.894
645.84,"vp8",320,240,95903,25.032558,138,16008,0,16146,1081321,6660941,7742262,5000000,15,640,480,218932,3.492
395.44,"vp8",1280,720,1611942,25.027847,80,9806,0,9886,5073258,74605061,79678319,539000,12,320,240,221160,2.316
106.765,"h264",1280,720,849586,25,66,2603,0,2669,4427240,6911026,11338266,5000000,25,320,240,219480,2.528
860.056,"vp8",1280,720,2688309,29.968605,277,25496,0,25773,12989828,276022270,289012098,56000,24,320,240,256496,4.64
239.14166,"h264",480,360,500198,25,110,5868,0,5978,1406751,13545526,14952277,3000000,29.97,1920,1080,105568,54.171
80.536,"h264",480,360,690041,29,43,2374,0,2417,618732,6327913,6946645,3000000,24,320,240,219480,4.084
63.667,"h264",640,480,972572,15,33,923,0,956,1259657,6480438,7740095,539000,25,176,144,219656,1.336
204.938,"h264",480,360,297373,16,111,3169,0,3280,1451634,6166260,7617894,242000,24,640,480,143844,8.985
217.518,"h264",480,360,83054,29,112,6408,0,6520,406683,1851539,2258222,820000,29.97,480,360,217080,0.944
64.933,"flv",320,240,236793,15,39,936,0,975,318954,1603007,1921961,109000,15,640,480,217080,4.772
476.957,"vp8",1280,720,1387100,30.05252,105,14200,0,14305,3487520,79210885,82698405,5000000,29.97,176,144,165696,3.56
1140.349,"vp8",1280,720,2394626,30.007017,328,33880,0,34208,20478926,320859863,341338789,3000000,29.97,1920,1080,652452,142.785
274.541,"vp8",480,360,139791,30.029198,58,8170,0,8228,802625,3994697,4797322,109000,25,1920,1080,216820,5.348
326.58832,"h264",1920,1080,5999648,23,174,7656,0,7830,16603953,228322925,244926878,5000000,29.97,640,480,218932,8.505
225.08,"h264",480,360,538452,25,113,5515,0,5628,1873408,13275961,15149369,539000,12,1280,720,216820,3.656
145.01167,"h264",1920,1080,1937657,29,75,4271,0,4346,4106960,31015916,35122876,3000000,24,176,144,79400,7.372
340.424,"flv",320,240,244491,11,69,4012,0,4081,1168939,9234909,10403848,5000000,25,320,240,221152,1.752
74.535,"mpeg4",176,144,55305,12,15,879,0,894,23996,491276,515272,56000,25,1920,1080,219200,11.921
1768.9417,"mpeg4",176,144,56152,12,354,20873,0,21227,1382103,11034284,12416387,56000,29.97,1920,1080,634092,42.359
250.017,"h264",320,240,153059,29,128,7366,0,7494,856855,3926589,4783444,56000,25,1280,720,316664,15.085
127.221664,"h264",1920,1080,3080852,23,70,2980,0,3050,3818903,45174992,48993895,242000,12,640,480,217544,17.709
440.967,"h264",320,240,281642,30,236,12994,0,13230,2444863,13079542,15524405,820000,25,320,240,219656,0.696
860.056,"vp8",1280,720,2688309,29.968605,277,25496,0,25773,12989828,276022270,289012098,820000,25,480,360,262592,15.853
316.95166,"mpeg4",176,144,55396,12,64,3739,0,3803,111850,2082902,2194752,820000,25,640,480,165700,0.716
270.655,"vp8",640,480,652967,30.062963,89,8028,0,8117,1912240,20178890,22091130,3000000,24,176,144,219480,3.528
189.956,"flv",320,240,231296,29,97,5597,0,5694,580292,4911734,5492026,539000,29.97,640,480,218664,1.12
98.683334,"mpeg4",176,144,55552,12,20,1164,0,1184,48267,636993,685260,5000000,12,480,360,218192,3.98
204.938,"h264",480,360,297373,16,111,3169,0,3280,1451634,6166260,7617894,56000,24,480,360,101592,4.376
34.168,"vp8",480,360,186895,30.029411,16,1005,0,1021,238485,559745,798230,242000,25,640,480,165700,4.364
1140.349,"vp8",1280,720,2394626,30.007017,328,33880,0,34208,20478926,320859863,341338789,820000,25,1280,720,67056,8.457
64.933,"flv",320,240,236793,15,39,936,0,975,318954,1603007,1921961,3000000,12,1280,720,217080,17.641
448.575,"vp8",1280,720,2052426,30.002232,92,13349,0,13441,9132637,105950761,115083398,820000,25,1920,1080,217080,57.776
157.891,"h264",480,360,406908,29,87,4646,0,4733,1776729,6254165,8030894,56000,15,320,240,219464,1.008
750.433,"vp8",1280,720,794075,13.482667,81,10031,0,10112,3852576,70635013,74487589,3000000,12,1920,1080,666924,47.955
273.816,"vp8",1920,1080,1571003,25.065933,77,6766,0,6843,6190779,47579961,53770740,3000000,12,176,144,219656,4.984
77.233,"h264",480,360,382461,30,53,2265,0,2318,182297,3510033,3692330,539000,12,1920,1080,219480,20.349
270.655,"vp8",640,480,652967,30.062963,89,8028,0,8117,1912240,20178890,22091130,109000,25,1280,720,219480,4.048
39.055,"h264",1920,1080,5992818,30,26,1144,0,1170,839251,28416939,29256190,539000,12,1280,720,215940,20.177
34.168,"vp8",480,360,186895,30.029411,16,1005,0,1021,238485,559745,798230,820000,24,640,480,165700,11.953
189.956,"flv",320,240,231296,29,97,5597,0,5694,580292,4911734,5492026,109000,15,320,240,218664,2.744
304.927,"vp8",320,240,134334,25.075659,82,7541,0,7623,833754,4286526,5120280,820000,15,640,480,216820,1.108
43.827,"flv",320,240,272273,25,23,1081,0,1104,137210,1354404,1491614,539000,29.97,480,360,218932,4.024
476.957,"vp8",1280,720,1387100,30.05252,105,14200,0,14305,3487520,79210885,82698405,56000,25,480,360,165700,3.272
311.1,"mpeg4",176,144,56416,12,113,3620,0,3733,127552,2066350,2193902,3000000,12,640,480,221160,0.6
107.443,"vp8",480,360,320011,30.093458,30,3190,0,3220,671936,3625932,4297868,242000,25,176,144,216820,2.3
385.052,"vp8",1280,720,441862,23.979221,77,9155,0,9232,16244376,5023129,21267505,109000,15,1280,720,219480,10.869
131.76,"vp8",640,480,104723,25.145039,37,3257,0,3294,945865,778937,1724802,539000,29.97,1280,720,325124,22.485
157.80167,"h264",1280,720,2885589,25,72,3873,0,3945,5611970,51306874,56918844,820000,24,480,360,216064,3.992
86.486,"h264",640,480,356037,29,46,2547,0,2593,819680,3029350,3849030,242000,24,1280,720,219656,15.285
130.35667,"mpeg4",176,144,54590,12,27,1537,0,1564,64483,825054,889537,5000000,25,640,480,60764,0.912
339.667,"h264",640,480,257699,30,181,10010,0,10191,10121223,820261,10941484,5000000,25,1920,1080,638176,53.155
203.198,"flv",320,240,239336,29,104,5974,0,6078,853613,5225468,6079081,3000000,12,320,240,221160,1.416
127.221664,"h264",1920,1080,3080852,23,70,2980,0,3050,3818903,45174992,48993895,109000,29.97,1280,720,393056,34.318
473,"h264",320,240,164017,25,198,10924,704,11826,1419320,8047423,9697521,56000,15,1280,720,220808,9.397
316.95166,"mpeg4",176,144,55396,12,64,3739,0,3803,111850,2082902,2194752,5000000,24,1920,1080,165700,3.416
750.433,"vp8",1280,720,794075,13.482667,81,10031,0,10112,3852576,70635013,74487589,820000,12,640,480,165700,4.428
286.995,"h264",480,360,508160,23,156,6726,0,6882,2285153,15944803,18229956,3000000,24,1280,720,216820,11.525
143.03334,"mpeg4",176,144,51082,12,31,1685,0,1716,56405,856907,913312,109000,12,1280,720,219480,3.588
250.017,"h264",320,240,153059,29,128,7366,0,7494,856855,3926589,4783444,539000,29.97,480,360,218664,5.932
452.689,"vp8",320,240,66680,5.7057524,42,2537,0,2579,207037,3566163,3773200,5000000,24,320,240,250568,0.648
33.09,"h264",320,240,279173,13,22,434,0,456,101794,1052937,1154731,242000,25,640,480,219480,0.992
458.625,"h264",640,480,517364,29,245,13501,0,13746,5308581,24350943,29659524,5000000,29.97,640,480,216820,4.756
143.03334,"mpeg4",176,144,51082,12,31,1685,0,1716,56405,856907,913312,242000,25,1280,720,219480,6.036
290.01666,"mpeg4",176,144,52783,12,61,3417,0,3478,119325,1794184,1913509,3000000,24,640,480,129236,3.268
290.01666,"mpeg4",176,144,52783,12,61,3417,0,3478,119325,1794184,1913509,3000000,15,1920,1080,629860,87.269
750.433,"vp8",1280,720,794075,13.482667,81,10031,0,10112,3852576,70635013,74487589,56000,25,1280,720,165700,2.708
215.43333,"h264",480,360,506638,30,127,6336,0,6463,619477,13023863,13643340,3000000,24,1280,720,69464,10.749
452.689,"vp8",320,240,66680,5.7057524,42,2537,0,2579,207037,3566163,3773200,539000,12,320,240,248092,3.072
476.957,"vp8",1280,720,1387100,30.05252,105,14200,0,14305,3487520,79210885,82698405,5000000,29.97,1920,1080,165700,56.288
163.897,"flv",320,240,267032,29,87,4826,0,4913,824159,4646573,5470732,3000000,25,640,480,219656,7.676
750.433,"vp8",1280,720,794075,13.482667,81,10031,0,10112,3852576,70635013,74487589,539000,25,176,144,165700,1.644
77.233,"h264",480,360,382461,30,53,2265,0,2318,182297,3510033,3692330,820000,29.97,480,360,219480,1.324
282.56,"h264",640,480,559834,25,145,6920,0,7065,4966509,14806840,19773349,539000,25,1920,1080,221152,5.204
1140.349,"vp8",1280,720,2394626,30.007017,328,33880,0,34208,20478926,320859863,341338789,539000,25,176,144,219480,7.344
157.891,"h264",480,360,406908,29,87,4646,0,4733,1776729,6254165,8030894,242000,12,1920,1080,653976,26.906
216.55,"h264",320,240,291150,29,112,6379,0,6491,1789334,6091735,7881069,5000000,29.97,320,240,200348,2.852
216.55,"h264",320,240,291150,29,112,6379,0,6491,1789334,6091735,7881069,109000,29.97,1920,1080,179488,16.669
473,"h264",320,240,164017,25,198,10924,704,11826,1419320,8047423,9697521,109000,25,320,240,219656,2.52
270.655,"vp8",640,480,652967,30.062963,89,8028,0,8117,1912240,20178890,22091130,539000,29.97,1280,720,219480,4.452
177.33333,"mpeg4",176,144,53707,12,37,2091,0,2128,100969,1089548,1190517,56000,25,640,480,163632,0.616
110.966995,"h264",480,360,397112,30,59,3271,0,3330,529627,4978664,5508291,820000,25,176,144,216820,2.408
167.39166,"h264",1280,720,2207484,24,86,3931,0,4017,4369420,41819887,46189307,5000000,25,176,144,219656,9.121
176.901,"vp8",480,360,26968,25.113636,38,4382,0,4420,393395,202954,596349,3000000,29.97,480,360,218932,0.68
452.689,"vp8",320,240,66680,5.7057524,42,2537,0,2579,207037,3566163,3773200,820000,25,1920,1080,247884,12.809
274.541,"vp8",480,360,139791,30.029198,58,8170,0,8228,802625,3994697,4797322,109000,15,480,360,216064,2.508
714.371,"vp8",1280,720,652356,29.981792,143,21264,0,21407,14532530,43720516,58253046,3000000,24,176,144,165564,2.964
157.80167,"h264",1280,720,2885589,25,72,3873,0,3945,5611970,51306874,56918844,3000000,12,1280,720,216020,5.736
67.583336,"mpeg4",176,144,51225,12,15,777,0,792,47585,385164,432749,109000,25,176,144,219480,0.284
86.486,"h264",640,480,356037,29,46,2547,0,2593,819680,3029350,3849030,109000,29.97,320,240,219656,3.836
67.583336,"mpeg4",176,144,51225,12,15,777,0,792,47585,385164,432749,5000000,12,320,240,219480,4.28
95.462,"h264",640,480,809256,29,51,2811,0,2862,886496,8770159,9656655,56000,24,320,240,221160,1.584
254.922,"vp8",480,360,260667,30.062992,51,7585,0,7636,918325,7387906,8306231,5000000,29.97,320,240,221160,3.656
64.933,"flv",320,240,236793,15,39,936,0,975,318954,1603007,1921961,539000,24,1920,1080,609500,54.819
326.583,"vp8",640,480,1055982,25.039877,102,8061,0,8163,1868804,41239444,43108248,109000,29.97,480,360,215712,9.161
34.168,"vp8",480,360,186895,30.029411,16,1005,0,1021,238485,559745,798230,539000,24,1920,1080,165700,12.593
157.80167,"h264",1280,720,2885589,25,72,3873,0,3945,5611970,51306874,56918844,109000,12,480,360,216056,3.768
177.33333,"mpeg4",176,144,53707,12,37,2091,0,2128,100969,1089548,1190517,539000,25,1920,1080,163024,19.173
581.233,"h264",480,360,295979,30,310,17128,0,17438,10151572,11352574,21504146,539000,24,640,480,218932,5.112
440.967,"h264",320,240,281642,30,236,12994,0,13230,2444863,13079542,15524405,3000000,24,1920,1080,219656,12.637
254.922,"vp8",480,360,260667,30.062992,51,7585,0,7636,918325,7387906,8306231,820000,15,640,480,221160,1.516
270.655,"vp8",640,480,652967,30.062963,89,8028,0,8117,1912240,20178890,22091130,56000,24,480,360,219480,7.7
645.84,"vp8",320,240,95903,25.032558,138,16008,0,16146,1081321,6660941,7742262,242000,12,1280,720,218932,3.664
95.462,"h264",640,480,809256,29,51,2811,0,2862,886496,8770159,9656655,56000,12,176,144,221160,2.412
203.198,"flv",320,240,239336,29,104,5974,0,6078,853613,5225468,6079081,3000000,15,176,144,221160,3.404
581.233,"h264",480,360,295979,30,310,17128,0,17438,10151572,11352574,21504146,3000000,29.97,480,360,218932,4.232
254.922,"vp8",480,360,260667,30.062992,51,7585,0,7636,918325,7387906,8306231,820000,25,480,360,221160,14.053
86.486,"h264",640,480,356037,29,46,2547,0,2593,819680,3029350,3849030,56000,15,1920,1080,668080,20.137
311.1,"mpeg4",176,144,56416,12,113,3620,0,3733,127552,2066350,2193902,539000,15,1920,1080,221160,6.616
1768.9417,"mpeg4",176,144,56152,12,354,20873,0,21227,1382103,11034284,12416387,539000,24,1280,720,221160,6.128
39.055,"h264",1920,1080,5992818,30,26,1144,0,1170,839251,28416939,29256190,56000,29.97,320,240,216020,14.497
176.901,"vp8",480,360,26968,25.113636,38,4382,0,4420,393395,202954,596349,820000,25,640,480,218932,1.052
750.433,"vp8",1280,720,794075,13.482667,81,10031,0,10112,3852576,70635013,74487589,242000,12,320,240,165700,2.384
130.35667,"mpeg4",176,144,54590,12,27,1537,0,1564,64483,825054,889537,3000000,29.97,320,240,58944,0.516
340.424,"flv",320,240,244491,11,69,4012,0,4081,1168939,9234909,10403848,5000000,25,640,480,221152,0.768
130.35667,"mpeg4",176,144,54590,12,27,1537,0,1564,64483,825054,889537,109000,25,640,480,134348,8.057
86.486,"h264",640,480,356037,29,46,2547,0,2593,819680,3029350,3849030,5000000,29.97,176,144,219656,1.26
67.583336,"mpeg4",176,144,51225,12,15,777,0,792,47585,385164,432749,820000,29.97,480,360,219480,3.064
34.168,"vp8",480,360,186895,30.029411,16,1005,0,1021,238485,559745,798230,820000,24,176,144,165700,1.892
106.765,"h264",1280,720,849586,25,66,2603,0,2669,4427240,6911026,11338266,109000,12,480,360,219480,2.684
282.56,"h264",640,480,559834,25,145,6920,0,7065,4966509,14806840,19773349,539000,29.97,176,144,221152,3.236
157.80167,"h264",1280,720,2885589,25,72,3873,0,3945,5611970,51306874,56918844,5000000,29.97,1920,1080,699692,131.972
239.14166,"h264",480,360,500198,25,110,5868,0,5978,1406751,13545526,14952277,242000,25,176,144,99888,2.42
385.052,"vp8",1280,720,441862,23.979221,77,9155,0,9232,16244376,5023129,21267505,820000,29.97,640,480,219480,5.588
316.95166,"mpeg4",176,144,55396,12,64,3739,0,3803,111850,2082902,2194752,5000000,24,176,144,165700,0.296
340.424,"flv",320,240,244491,11,69,4012,0,4081,1168939,9234909,10403848,242000,15,320,240,221152,0.348
43.827,"flv",320,240,272273,25,23,1081,0,1104,137210,1354404,1491614,820000,25,1280,720,218932,22.953
316.95166,"mpeg4",176,144,55396,12,64,3739,0,3803,111850,2082902,2194752,539000,12,1280,720,165700,3.528
42.2,"h264",480,360,288705,25,23,1033,0,1056,216154,1306770,1522924,820000,29.97,640,480,216820,6.996
127.221664,"h264",1920,1080,3080852,23,70,2980,0,3050,3818903,45174992,48993895,820000,25,1920,1080,217436,50.395
69.93833,"mpeg4",176,144,56717,12,14,825,0,839,47521,448322,495843,56000,25,640,480,221152,2.728
426.945,"h264",1280,720,1064703,29,228,12567,0,12795,11297544,45523691,56821235,820000,24,176,144,219480,3.528
385.052,"vp8",1280,720,441862,23.979221,77,9155,0,9232,16244376,5023129,21267505,5000000,12,1920,1080,219480,4.176
157.891,"h264",480,360,406908,29,87,4646,0,4733,1776729,6254165,8030894,3000000,25,640,480,219464,5.692
273.816,"vp8",1920,1080,1571003,25.065933,77,6766,0,6843,6190779,47579961,53770740,820000,12,640,480,219656,10.745
286.995,"h264",480,360,508160,23,156,6726,0,6882,2285153,15944803,18229956,5000000,12,320,240,216820,1.128
440.967,"h264",320,240,281642,30,236,12994,0,13230,2444863,13079542,15524405,109000,12,176,144,219656,1.48
714.371,"vp8",1280,720,652356,29.981792,143,21264,0,21407,14532530,43720516,58253046,3000000,24,1920,1080,165564,7.756
270.655,"vp8",640,480,652967,30.062963,89,8028,0,8117,1912240,20178890,22091130,820000,12,320,240,219480,7.04
384.451,"h264",640,480,646432,29,205,11318,0,11523,2839955,28225248,31065203,56000,25,480,360,217828,7.132
304.927,"vp8",320,240,134334,25.075659,82,7541,0,7623,833754,4286526,5120280,539000,12,176,144,216820,2.068
52.68,"h264",480,360,372001,25,53,1265,0,1318,870136,1579497,2449633,242000,15,640,480,140080,7.16
222.53334,"h264",480,360,500449,30,219,6457,0,6676,2821722,11099102,13920824,56000,12,176,144,217324,1.308
77.233,"h264",480,360,382461,30,53,2265,0,2318,182297,3510033,3692330,242000,29.97,1920,1080,644088,53.055
290.01666,"mpeg4",176,144,52783,12,61,3417,0,3478,119325,1794184,1913509,242000,25,640,480,139932,10.709
80.536,"h264",480,360,690041,29,43,2374,0,2417,618732,6327913,6946645,242000,25,320,240,219480,1.468
326.58832,"h264",1920,1080,5999648,23,174,7656,0,7830,16603953,228322925,244926878,3000000,24,640,480,218932,42.023
225.08,"h264",480,360,538452,25,113,5515,0,5628,1873408,13275961,15149369,539000,15,480,360,216820,4.128
368.32,"vp8",640,480,29096,25.02174,74,9134,0,9208,869558,470067,1339625,3000000,29.97,320,240,221152,0.84
271.08,"vp8",480,360,234680,25.00738,61,6716,0,6777,750452,7201680,7952132,3000000,12,1920,1080,84860,32.426
448.575,"vp8",1280,720,2052426,30.002232,92,13349,0,13441,9132637,105950761,115083398,820000,25,480,360,217080,18.757
59.883,"vp8",1280,720,994960,30.38983,13,1780,0,1793,481774,6965881,7447655,5000000,24,480,360,155028,4.884
176.901,"vp8",480,360,26968,25.113636,38,4382,0,4420,393395,202954,596349,5000000,12,1280,720,218932,2.728
131.76,"vp8",640,480,104723,25.145039,37,3257,0,3294,945865,778937,1724802,56000,29.97,320,240,221152,2.736
340.424,"flv",320,240,244491,11,69,4012,0,4081,1168939,9234909,10403848,539000,24,320,240,221152,1.708
250.017,"h264",320,240,153059,29,128,7366,0,7494,856855,3926589,4783444,539000,25,1920,1080,218900,5.276
290.01666,"mpeg4",176,144,52783,12,61,3417,0,3478,119325,1794184,1913509,56000,12,1920,1080,135676,3.072
38.452,"vp8",1280,720,2047310,30.289474,8,1143,0,1151,602537,9237861,9840398,3000000,12,176,144,59500,4.84
34.168,"vp8",480,360,186895,30.029411,16,1005,0,1021,238485,559745,798230,5000000,12,176,144,165700,1.784
222.53334,"h264",480,360,500449,30,219,6457,0,6676,2821722,11099102,13920824,539000,25,640,480,217336,3.784
52.68,"h264",480,360,372001,25,53,1265,0,1318,870136,1579497,2449633,539000,15,176,144,140080,2.292
43.827,"flv",320,240,272273,25,23,1081,0,1104,137210,1354404,1491614,56000,29.97,1280,720,218932,17.281
225.08,"h264",480,360,538452,25,113,5515,0,5628,1873408,13275961,15149369,242000,15,640,480,216820,1.304
3242.6667,"mpeg4",176,144,56442,12,649,38263,0,38912,3829992,19047921,22877913,5000000,29.97,480,360,36004,2.328
163.897,"flv",320,240,267032,29,87,4826,0,4913,824159,4646573,5470732,56000,25,1920,1080,219656,12.193
256.20834,"mpeg4",176,144,57565,12,56,3018,0,3074,302900,1540700,1843600,5000000,12,480,360,219480,0.536
750.433,"vp8",1280,720,794075,13.482667,81,10031,0,10112,3852576,70635013,74487589,5000000,24,176,144,175320,3.088
282.56,"h264",640,480,559834,25,145,6920,0,7065,4966509,14806840,19773349,109000,29.97,176,144,221152,1.104
216.55,"h264",320,240,291150,29,112,6379,0,6491,1789334,6091735,7881069,5000000,25,1920,1080,200320,43.407
292.092,"h264",480,360,480125,29,156,8599,0,8755,2375028,15155062,17530090,3000000,24,640,480,219480,36.634
225.08,"h264",480,360,538452,25,113,5515,0,5628,1873408,13275961,15149369,109000,25,640,480,216820,9.461
250.017,"h264",320,240,153059,29,128,7366,0,7494,856855,3926589,4783444,56000,15,480,360,218900,4.028
290.01666,"mpeg4",176,144,52783,12,61,3417,0,3478,119325,1794184,1913509,242000,29.97,1280,720,136036,1.46
270.655,"vp8",640,480,652967,30.062963,89,8028,0,8117,1912240,20178890,22091130,539000,12,640,480,219480,2.612
69.93833,"mpeg4",176,144,56717,12,14,825,0,839,47521,448322,495843,820000,15,480,360,221152,6.14
379.32,"h264",480,360,181960,25,195,9289,0,9484,3392479,5235193,8627672,242000,15,1920,1080,652036,27.074
270.655,"vp8",640,480,652967,30.062963,89,8028,0,8117,1912240,20178890,22091130,820000,24,480,360,219480,2.14
270.655,"vp8",640,480,652967,30.062963,89,8028,0,8117,1912240,20178890,22091130,5000000,29.97,640,480,219480,6.916
458.625,"h264",640,480,517364,29,245,13501,0,13746,5308581,24350943,29659524,3000000,24,320,240,216820,4.924
384.451,"h264",640,480,646432,29,205,11318,0,11523,2839955,28225248,31065203,56000,25,176,144,217544,2.772
860.056,"vp8",1280,720,2688309,29.968605,277,25496,0,25773,12989828,276022270,289012098,56000,12,480,360,262784,4.256
63.667,"h264",640,480,972572,15,33,923,0,956,1259657,6480438,7740095,539000,24,1920,1080,219656,35.454
1140.349,"vp8",1280,720,2394626,30.007017,328,33880,0,34208,20478926,320859863,341338789,3000000,25,176,144,219480,3.964
189.956,"flv",320,240,231296,29,97,5597,0,5694,580292,4911734,5492026,5000000,29.97,480,360,218664,4.568
254.922,"vp8",480,360,260667,30.062992,51,7585,0,7636,918325,7387906,8306231,109000,12,320,240,221160,0.968
167.39166,"h264",1280,720,2207484,24,86,3931,0,4017,4369420,41819887,46189307,242000,25,320,240,219656,9.057
326.583,"vp8",640,480,1055982,25.039877,102,8061,0,8163,1868804,41239444,43108248,242000,15,640,480,215712,11.689
106.765,"h264",1280,720,849586,25,66,2603,0,2669,4427240,6911026,11338266,5000000,12,1280,720,219480,9.949
340.424,"flv",320,240,244491,11,69,4012,0,4081,1168939,9234909,10403848,242000,24,640,480,221152,10.493
1140.349,"vp8",1280,720,2394626,30.007017,328,33880,0,34208,20478926,320859863,341338789,3000000,24,640,480,219480,6.244
581.233,"h264",480,360,295979,30,310,17128,0,17438,10151572,11352574,21504146,242000,24,320,240,218932,5.084
254.922,"vp8",480,360,260667,30.062992,51,7585,0,7636,918325,7387906,8306231,820000,29.97,1280,720,221160,21.561
37.011665,"h264",1280,720,2759449,29,21,1088,0,1109,1899633,10866846,12766479,5000000,12,1920,1080,219480,8.517
391.08,"h264",640,480,230847,25,209,9569,0,9778,9023743,2261252,11284995,109000,29.97,480,360,219480,3.884
131.76,"vp8",640,480,104723,25.145039,37,3257,0,3294,945865,778937,1724802,5000000,29.97,1920,1080,221152,4.96
750.433,"vp8",1280,720,794075,13.482667,81,10031,0,10112,3852576,70635013,74487589,109000,15,176,144,167052,2.424
163.897,"flv",320,240,267032,29,87,4826,0,4913,824159,4646573,5470732,820000,29.97,320,240,219656,2.236
750.433,"vp8",1280,720,794075,13.482667,81,10031,0,10112,3852576,70635013,74487589,56000,12,320,240,165700,1.72
157.891,"h264",480,360,406908,29,87,4646,0,4733,1776729,6254165,8030894,242000,29.97,480,360,219464,8.093
368.32,"vp8",640,480,29096,25.02174,74,9134,0,9208,869558,470067,1339625,109000,24,1920,1080,221152,10.493
282.56,"h264",640,480,559834,25,145,6920,0,7065,4966509,14806840,19773349,109000,29.97,176,144,220900,2.832
189.956,"flv",320,240,231296,29,97,5597,0,5694,580292,4911734,5492026,539000,25,320,240,218664,5.332
270.655,"vp8",640,480,652967,30.062963,89,8028,0,8117,1912240,20178890,22091130,3000000,24,1280,720,219480,33.834
86.486,"h264",640,480,356037,29,46,2547,0,2593,819680,3029350,3849030,109000,12,1280,720,219656,2.268
339.667,"h264",640,480,257699,30,181,10010,0,10191,10121223,820261,10941484,56000,24,1920,1080,219480,11.153
222.53334,"h264",480,360,500449,30,219,6457,0,6676,2821722,11099102,13920824,3000000,25,1280,720,217348,21.873
273.816,"vp8",1920,1080,1571003,25.065933,77,6766,0,6843,6190779,47579961,53770740,5000000,25,176,144,219656,6.276
203.198,"flv",320,240,239336,29,104,5974,0,6078,853613,5225468,6079081,109000,29.97,1920,1080,221160,6.568
69.93833,"mpeg4",176,144,56717,12,14,825,0,839,47521,448322,495843,109000,12,640,480,221152,1.668
274.541,"vp8",480,360,139791,30.029198,58,8170,0,8228,802625,3994697,4797322,56000,25,640,480,216820,7.512
106.765,"h264",1280,720,849586,25,66,2603,0,2669,4427240,6911026,11338266,3000000,15,480,360,219480,9.497
282.56,"h264",640,480,559834,25,145,6920,0,7065,4966509,14806840,19773349,539000,24,1920,1080,662232,44.427
304.927,"vp8",320,240,134334,25.075659,82,7541,0,7623,833754,4286526,5120280,539000,29.97,1920,1080,216820,16.045
177.33333,"mpeg4",176,144,53707,12,37,2091,0,2128,100969,1089548,1190517,242000,12,176,144,163024,0.944
176.901,"vp8",480,360,26968,25.113636,38,4382,0,4420,393395,202954,596349,242000,25,1280,720,218932,12.129
714.371,"vp8",1280,720,652356,29.981792,143,21264,0,21407,14532530,43720516,58253046,539000,24,640,480,164888,12.053
204.938,"h264",480,360,297373,16,111,3169,0,3280,1451634,6166260,7617894,5000000,29.97,320,240,82764,2.244
203.198,"flv",320,240,239336,29,104,5974,0,6078,853613,5225468,6079081,3000000,29.97,1920,1080,611204,128.16
239.14166,"h264",480,360,500198,25,110,5868,0,5978,1406751,13545526,14952277,539000,25,480,360,112564,1.244
384.451,"h264",640,480,646432,29,205,11318,0,11523,2839955,28225248,31065203,539000,29.97,1920,1080,217828,7.3
131.76,"vp8",640,480,104723,25.145039,37,3257,0,3294,945865,778937,1724802,109000,24,1920,1080,221152,4.544
131.76,"vp8",640,480,104723,25.145039,37,3257,0,3294,945865,778937,1724802,109000,24,320,240,221152,0.9
292.092,"h264",480,360,480125,29,156,8599,0,8755,2375028,15155062,17530090,539000,15,480,360,219480,6.148
67.583336,"mpeg4",176,144,51225,12,15,777,0,792,47585,385164,432749,539000,12,1280,720,309492,21.085
490.6,"h264",480,360,300437,25,256,12010,0,12266,1448177,16976151,18424328,109000,12,320,240,219480,3.092
74.535,"mpeg4",176,144,55305,12,15,879,0,894,23996,491276,515272,539000,25,1920,1080,219200,18.233
167.39166,"h264",1280,720,2207484,24,86,3931,0,4017,4369420,41819887,46189307,539000,12,320,240,219656,4.088
176.901,"vp8",480,360,26968,25.113636,38,4382,0,4420,393395,202954,596349,539000,12,1280,720,218932,5.692
292.092,"h264",480,360,480125,29,156,8599,0,8755,2375028,15155062,17530090,109000,12,1920,1080,219480,7.56
167.39166,"h264",1280,720,2207484,24,86,3931,0,4017,4369420,41819887,46189307,820000,24,1280,720,219656,6.988
1768.9417,"mpeg4",176,144,56152,12,354,20873,0,21227,1382103,11034284,12416387,109000,15,1280,720,221160,4.192
225.08,"h264",480,360,538452,25,113,5515,0,5628,1873408,13275961,15149369,3000000,15,320,240,216820,6.808
395.44,"vp8",1280,720,1611942,25.027847,80,9806,0,9886,5073258,74605061,79678319,820000,12,176,144,221160,1.72
273.816,"vp8",1920,1080,1571003,25.065933,77,6766,0,6843,6190779,47579961,53770740,56000,15,320,240,219656,7.216
77.233,"h264",480,360,382461,30,53,2265,0,2318,182297,3510033,3692330,109000,25,1280,720,219480,3.076
286.995,"h264",480,360,508160,23,156,6726,0,6882,2285153,15944803,18229956,5000000,12,176,144,216820,1.076
64.933,"flv",320,240,236793,15,39,936,0,975,318954,1603007,1921961,109000,12,640,480,217080,4.296
1768.9417,"mpeg4",176,144,56152,12,354,20873,0,21227,1382103,11034284,12416387,3000000,15,320,240,244884,7.924
203.198,"flv",320,240,239336,29,104,5974,0,6078,853613,5225468,6079081,539000,25,640,480,221160,4.376
157.891,"h264",480,360,406908,29,87,4646,0,4733,1776729,6254165,8030894,539000,24,320,240,219464,1.084
52.68,"h264",480,360,372001,25,53,1265,0,1318,870136,1579497,2449633,539000,24,1920,1080,139940,13.085
1768.9417,"mpeg4",176,144,56152,12,354,20873,0,21227,1382103,11034284,12416387,109000,25,176,144,228992,0.312
440.967,"h264",320,240,281642,30,236,12994,0,13230,2444863,13079542,15524405,109000,29.97,320,240,219656,2.408
217.518,"h264",480,360,83054,29,112,6408,0,6520,406683,1851539,2258222,242000,12,1280,720,216820,3.324
163.897,"flv",320,240,267032,29,87,4826,0,4913,824159,4646573,5470732,820000,25,1920,1080,219656,5.34
286.995,"h264",480,360,508160,23,156,6726,0,6882,2285153,15944803,18229956,5000000,15,640,480,216820,5.064
906.5983,"mpeg4",176,144,56108,12,187,10692,0,10879,597549,5760936,6358485,56000,12,176,144,165668,1.12
98.683334,"mpeg4",176,144,55552,12,20,1164,0,1184,48267,636993,685260,242000,25,480,360,218136,4.204
222.53334,"h264",480,360,500449,30,219,6457,0,6676,2821722,11099102,13920824,242000,24,176,144,217336,2.256
127.221664,"h264",1920,1080,3080852,23,70,2980,0,3050,3818903,45174992,48993895,3000000,29.97,176,144,217348,7.936
282.56,"h264",640,480,559834,25,145,6920,0,7065,4966509,14806840,19773349,820000,12,480,360,221152,1.296
440.967,"h264",320,240,281642,30,236,12994,0,13230,2444863,13079542,15524405,3000000,24,640,480,219656,5.628
750.433,"vp8",1280,720,794075,13.482667,81,10031,0,10112,3852576,70635013,74487589,109000,24,176,144,165700,1.608
270.655,"vp8",640,480,652967,30.062963,89,8028,0,8117,1912240,20178890,22091130,109000,12,1920,1080,219480,5.048
256.20834,"mpeg4",176,144,57565,12,56,3018,0,3074,302900,1540700,1843600,539000,25,176,144,219480,0.676
340.424,"flv",320,240,244491,11,69,4012,0,4081,1168939,9234909,10403848,820000,15,176,144,221152,1.084
131.76,"vp8",640,480,104723,25.145039,37,3257,0,3294,945865,778937,1724802,539000,15,320,240,221152,1.788
157.891,"h264",480,360,406908,29,87,4646,0,4733,1776729,6254165,8030894,5000000,15,320,240,219464,2.192
254.922,"vp8",480,360,260667,30.062992,51,7585,0,7636,918325,7387906,8306231,820000,15,176,144,221160,0.932
254.922,"vp8",480,360,260667,30.062992,51,7585,0,7636,918325,7387906,8306231,242000,24,640,480,221160,4.588
69.93833,"mpeg4",176,144,56717,12,14,825,0,839,47521,448322,495843,5000000,25,640,480,221152,0.692
292.092,"h264",480,360,480125,29,156,8599,0,8755,2375028,15155062,17530090,539000,12,176,144,219480,1.212
106.765,"h264",1280,720,849586,25,66,2603,0,2669,4427240,6911026,11338266,5000000,12,176,144,219480,2.744
311.1,"mpeg4",176,144,56416,12,113,3620,0,3733,127552,2066350,2193902,242000,15,1920,1080,634400,27.118
458.625,"h264",640,480,517364,29,245,13501,0,13746,5308581,24350943,29659524,820000,12,1920,1080,216820,19.549
339.667,"h264",640,480,257699,30,181,10010,0,10191,10121223,820261,10941484,242000,25,640,480,219480,3.864
77.233,"h264",480,360,382461,30,53,2265,0,2318,182297,3510033,3692330,820000,24,1920,1080,219480,36.25
385.052,"vp8",1280,720,441862,23.979221,77,9155,0,9232,16244376,5023129,21267505,539000,15,320,240,219480,2.068
860.056,"vp8",1280,720,2688309,29.968605,277,25496,0,25773,12989828,276022270,289012098,242000,15,176,144,262060,5.332
750.433,"vp8",1280,720,794075,13.482667,81,10031,0,10112,3852576,70635013,74487589,5000000,29.97,1920,1080,165700,14.369
86.486,"h264",640,480,356037,29,46,2547,0,2593,819680,3029350,3849030,109000,12,320,240,219656,2.364
395.44,"vp8",1280,720,1611942,25.027847,80,9806,0,9886,5073258,74605061,79678319,3000000,12,1920,1080,221160,6.756
340.424,"flv",320,240,244491,11,69,4012,0,4081,1168939,9234909,10403848,109000,12,480,360,221152,1.64
131.76,"vp8",640,480,104723,25.145039,37,3257,0,3294,945865,778937,1724802,820000,12,176,144,221152,1.304
270.655,"vp8",640,480,652967,30.062963,89,8028,0,8117,1912240,20178890,22091130,3000000,24,640,480,219480,6.3
311.1,"mpeg4",176,144,56416,12,113,3620,0,3733,127552,2066350,2193902,5000000,29.97,640,480,221160,2.828
31.133,"vp8",640,480,273737,29.967741,9,920,0,929,229015,836268,1065283,5000000,12,1920,1080,88280,28.978
189.956,"flv",320,240,231296,29,97,5597,0,5694,580292,4911734,5492026,539000,12,1920,1080,637424,41.267
440.967,"h264",320,240,281642,30,236,12994,0,13230,2444863,13079542,15524405,109000,29.97,1920,1080,219656,5.664
77.233,"h264",480,360,382461,30,53,2265,0,2318,182297,3510033,3692330,109000,25,480,360,219480,4.808
106.765,"h264",1280,720,849586,25,66,2603,0,2669,4427240,6911026,11338266,242000,12,176,144,219480,3.176
37.011665,"h264",1280,720,2759449,29,21,1088,0,1109,1899633,10866846,12766479,3000000,25,1920,1080,219480,69.152
273.816,"vp8",1920,1080,1571003,25.065933,77,6766,0,6843,6190779,47579961,53770740,56000,12,480,360,219656,5.588
714.371,"vp8",1280,720,652356,29.981792,143,21264,0,21407,14532530,43720516,58253046,539000,12,1920,1080,164888,25.382
750.433,"vp8",1280,720,794075,13.482667,81,10031,0,10112,3852576,70635013,74487589,5000000,25,480,360,175640,11.153
304.927,"vp8",320,240,134334,25.075659,82,7541,0,7623,833754,4286526,5120280,539000,15,320,240,216820,3.928
77.233,"h264",480,360,382461,30,53,2265,0,2318,182297,3510033,3692330,109000,24,1280,720,219480,9.733
270.655,"vp8",640,480,652967,30.062963,89,8028,0,8117,1912240,20178890,22091130,5000000,12,640,480,219480,3.096
452.689,"vp8",320,240,66680,5.7057524,42,2537,0,2579,207037,3566163,3773200,539000,12,1920,1080,248108,3.624
222.53334,"h264",480,360,500449,30,219,6457,0,6676,2821722,11099102,13920824,5000000,29.97,176,144,217348,2.22
64.08667,"h264",1280,720,3051286,29,35,1885,0,1920,620056,23823289,24443345,56000,15,640,480,66308,6.02
385.052,"vp8",1280,720,441862,23.979221,77,9155,0,9232,16244376,5023129,21267505,539000,29.97,1280,720,219480,9.401
197.60167,"mpeg4",176,144,53095,12,42,2329,0,2371,99309,1212164,1311473,820000,29.97,176,144,33352,2.44
225.08,"h264",480,360,538452,25,113,5515,0,5628,1873408,13275961,15149369,3000000,29.97,640,480,216820,8.221
225.08,"h264",480,360,538452,25,113,5515,0,5628,1873408,13275961,15149369,539000,25,320,240,216820,7.012
43.827,"flv",320,240,272273,25,23,1081,0,1104,137210,1354404,1491614,109000,15,640,480,218932,8.253
311.1,"mpeg4",176,144,56416,12,113,3620,0,3733,127552,2066350,2193902,3000000,24,176,144,221160,0.664
239.14166,"h264",480,360,500198,25,110,5868,0,5978,1406751,13545526,14952277,109000,15,1280,720,99528,11.693
77.233,"h264",480,360,382461,30,53,2265,0,2318,182297,3510033,3692330,56000,24,480,360,219480,3.624
714.371,"vp8",1280,720,652356,29.981792,143,21264,0,21407,14532530,43720516,58253046,242000,25,176,144,164736,3.644
239.14166,"h264",480,360,500198,25,110,5868,0,5978,1406751,13545526,14952277,3000000,24,480,360,121880,18.993
452.689,"vp8",320,240,66680,5.7057524,42,2537,0,2579,207037,3566163,3773200,3000000,25,480,360,248092,6.524
127.221664,"h264",1920,1080,3080852,23,70,2980,0,3050,3818903,45174992,48993895,242000,29.97,176,144,217348,7.956
476.957,"vp8",1280,720,1387100,30.05252,105,14200,0,14305,3487520,79210885,82698405,242000,12,1280,720,323572,18.293
395.44,"vp8",1280,720,1611942,25.027847,80,9806,0,9886,5073258,74605061,79678319,109000,29.97,320,240,221160,4.208
326.58832,"h264",1920,1080,5999648,23,174,7656,0,7830,16603953,228322925,244926878,109000,15,176,144,218932,8.429
645.84,"vp8",320,240,95903,25.032558,138,16008,0,16146,1081321,6660941,7742262,242000,24,320,240,219200,0.676
95.462,"h264",640,480,809256,29,51,2811,0,2862,886496,8770159,9656655,5000000,12,480,360,221160,2.96
750.433,"vp8",1280,720,794075,13.482667,81,10031,0,10112,3852576,70635013,74487589,242000,25,1920,1080,165700,12.377
167.39166,"h264",1280,720,2207484,24,86,3931,0,4017,4369420,41819887,46189307,820000,12,320,240,219656,9.557
440.967,"h264",320,240,281642,30,236,12994,0,13230,2444863,13079542,15524405,539000,24,480,360,219656,3.76
270.655,"vp8",640,480,652967,30.062963,89,8028,0,8117,1912240,20178890,22091130,109000,15,1280,720,219480,15.341
452.689,"vp8",320,240,66680,5.7057524,42,2537,0,2579,207037,3566163,3773200,820000,29.97,320,240,247884,2.716
860.056,"vp8",1280,720,2688309,29.968605,277,25496,0,25773,12989828,276022270,289012098,539000,15,176,144,262064,5.512
98.683334,"mpeg4",176,144,55552,12,20,1164,0,1184,48267,636993,685260,56000,29.97,1280,720,217852,7.4
311.1,"mpeg4",176,144,56416,12,113,3620,0,3733,127552,2066350,2193902,242000,29.97,1920,1080,633648,40.279
52.68,"h264",480,360,372001,25,53,1265,0,1318,870136,1579497,2449633,56000,15,1280,720,139940,4.856
239.14166,"h264",480,360,500198,25,110,5868,0,5978,1406751,13545526,14952277,56000,29.97,1920,1080,99484,32.206
395.44,"vp8",1280,720,1611942,25.027847,80,9806,0,9886,5073258,74605061,79678319,56000,12,320,240,221160,1.524
282.56,"h264",640,480,559834,25,145,6920,0,7065,4966509,14806840,19773349,820000,29.97,480,360,221152,3.72
273.816,"vp8",1920,1080,1571003,25.065933,77,6766,0,6843,6190779,47579961,53770740,539000,24,1920,1080,649612,53.823
311.1,"mpeg4",176,144,56416,12,113,3620,0,3733,127552,2066350,2193902,109000,29.97,320,240,221160,1.364
167.39166,"h264",1280,720,2207484,24,86,3931,0,4017,4369420,41819887,46189307,820000,12,176,144,219656,6.676
274.541,"vp8",480,360,139791,30.029198,58,8170,0,8228,802625,3994697,4797322,56000,24,176,144,216064,1.784
384.451,"h264",640,480,646432,29,205,11318,0,11523,2839955,28225248,31065203,109000,25,1280,720,217544,8.037
95.462,"h264",640,480,809256,29,51,2811,0,2862,886496,8770159,9656655,3000000,24,1920,1080,221160,13.249
750.433,"vp8",1280,720,794075,13.482667,81,10031,0,10112,3852576,70635013,74487589,56000,12,640,480,165700,1.896
176.901,"vp8",480,360,26968,25.113636,38,4382,0,4420,393395,202954,596349,242000,12,1280,720,218932,6.668
1768.9417,"mpeg4",176,144,56152,12,354,20873,0,21227,1382103,11034284,12416387,539000,24,176,144,232136,0.32
316.95166,"mpeg4",176,144,55396,12,64,3739,0,3803,111850,2082902,2194752,109000,29.97,480,360,165700,5.636
448.575,"vp8",1280,720,2052426,30.002232,92,13349,0,13441,9132637,105950761,115083398,539000,25,320,240,217080,4.628
1768.9417,"mpeg4",176,144,56152,12,354,20873,0,21227,1382103,11034284,12416387,242000,29.97,1280,720,221160,6.876
326.583,"vp8",640,480,1055982,25.039877,102,8061,0,8163,1868804,41239444,43108248,539000,15,176,144,212772,2.076
217.518,"h264",480,360,83054,29,112,6408,0,6520,406683,1851539,2258222,3000000,12,480,360,216820,2.028
189.956,"flv",320,240,231296,29,97,5597,0,5694,580292,4911734,5492026,5000000,12,1920,1080,218664,17.953
42.2,"h264",480,360,288705,25,23,1033,0,1056,216154,1306770,1522924,820000,29.97,1280,720,216820,17.209
384.451,"h264",640,480,646432,29,205,11318,0,11523,2839955,28225248,31065203,820000,24,480,360,217568,7.228
326.583,"vp8",640,480,1055982,25.039877,102,8061,0,8163,1868804,41239444,43108248,3000000,25,640,480,215712,28.786
74.535,"mpeg4",176,144,55305,12,15,879,0,894,23996,491276,515272,56000,24,176,144,219464,1.356
98.683334,"mpeg4",176,144,55552,12,20,1164,0,1184,48267,636993,685260,5000000,12,640,480,217880,3.012
49.178333,"mpeg4",176,144,54338,7,10,334,0,344,33046,300986,334032,56000,15,640,480,221152,1.74
290.01666,"mpeg4",176,144,52783,12,61,3417,0,3478,119325,1794184,1913509,539000,25,1920,1080,132936,20.297
426.945,"h264",1280,720,1064703,29,228,12567,0,12795,11297544,45523691,56821235,3000000,29.97,1920,1080,219480,53.651
750.433,"vp8",1280,720,794075,13.482667,81,10031,0,10112,3852576,70635013,74487589,820000,24,320,240,165700,3.116
426.945,"h264",1280,720,1064703,29,228,12567,0,12795,11297544,45523691,56821235,5000000,25,1920,1080,675520,131.288
906.5983,"mpeg4",176,144,56108,12,187,10692,0,10879,597549,5760936,6358485,5000000,29.97,1920,1080,165668,14.133
110.966995,"h264",480,360,397112,30,59,3271,0,3330,529627,4978664,5508291,242000,29.97,480,360,216820,6.164
69.933,"flv",320,240,272898,15,37,1013,0,1050,349781,2035796,2385577,820000,15,640,480,219656,3.48
52.68,"h264",480,360,372001,25,53,1265,0,1318,870136,1579497,2449633,5000000,12,320,240,140080,1.996
391.08,"h264",640,480,230847,25,209,9569,0,9778,9023743,2261252,11284995,3000000,15,1280,720,219480,2.208
225.08,"h264",480,360,538452,25,113,5515,0,5628,1873408,13275961,15149369,820000,24,640,480,216820,5.12
63.667,"h264",640,480,972572,15,33,923,0,956,1259657,6480438,7740095,539000,24,1280,720,219656,23.133
326.583,"vp8",640,480,1055982,25.039877,102,8061,0,8163,1868804,41239444,43108248,5000000,15,320,240,215712,8.821
239.14166,"h264",480,360,500198,25,110,5868,0,5978,1406751,13545526,14952277,109000,25,320,240,118256,4.996
74.535,"mpeg4",176,144,55305,12,15,879,0,894,23996,491276,515272,820000,25,320,240,219464,4.348
384.451,"h264",640,480,646432,29,205,11318,0,11523,2839955,28225248,31065203,3000000,25,640,480,217568,10.473
110.966995,"h264",480,360,397112,30,59,3271,0,3330,529627,4978664,5508291,242000,15,480,360,216820,8.601
107.443,"vp8",480,360,320011,30.093458,30,3190,0,3220,671936,3625932,4297868,56000,12,1280,720,319872,11.641
64.933,"flv",320,240,236793,15,39,936,0,975,318954,1603007,1921961,539000,24,176,144,217080,0.384
143.03334,"mpeg4",176,144,51082,12,31,1685,0,1716,56405,856907,913312,56000,25,176,144,219480,1.148
143.03334,"mpeg4",176,144,51082,12,31,1685,0,1716,56405,856907,913312,56000,29.97,1920,1080,219480,17.373
311.1,"mpeg4",176,144,56416,12,113,3620,0,3733,127552,2066350,2193902,56000,24,1920,1080,221160,13.357
130.35667,"mpeg4",176,144,54590,12,27,1537,0,1564,64483,825054,889537,109000,25,480,360,51332,0.512
516.207,"vp8",640,480,387593,30.005814,169,15314,0,15483,2905770,22104018,25009788,109000,15,480,360,97960,4.344
239.14166,"h264",480,360,500198,25,110,5868,0,5978,1406751,13545526,14952277,109000,25,480,360,94944,2.468
311.1,"mpeg4",176,144,56416,12,113,3620,0,3733,127552,2066350,2193902,109000,15,480,360,221160,1.972
203.198,"flv",320,240,239336,29,104,5974,0,6078,853613,5225468,6079081,820000,24,1280,720,221160,2.612
1140.349,"vp8",1280,720,2394626,30.007017,328,33880,0,34208,20478926,320859863,341338789,3000000,15,1280,720,316456,54.391
391.08,"h264",640,480,230847,25,209,9569,0,9778,9023743,2261252,11284995,242000,12,176,144,219480,0.872
255.28,"flv",320,240,250276,25,110,6272,0,6382,611474,7374864,7986338,820000,15,176,144,216820,1.56
177.33333,"mpeg4",176,144,53707,12,37,2091,0,2128,100969,1089548,1190517,539000,15,640,480,163024,5.1
340.424,"flv",320,240,244491,11,69,4012,0,4081,1168939,9234909,10403848,539000,15,1280,720,221152,5.184
163.897,"flv",320,240,267032,29,87,4826,0,4913,824159,4646573,5470732,539000,15,640,480,219656,1.036
69.93833,"mpeg4",176,144,56717,12,14,825,0,839,47521,448322,495843,109000,15,480,360,221152,1.432
110.966995,"h264",480,360,397112,30,59,3271,0,3330,529627,4978664,5508291,539000,24,176,144,216820,1.084
34.168,"vp8",480,360,186895,30.029411,16,1005,0,1021,238485,559745,798230,539000,24,320,240,165700,4.216
39.055,"h264",1920,1080,5992818,30,26,1144,0,1170,839251,28416939,29256190,820000,15,480,360,215848,10.373
368.32,"vp8",640,480,29096,25.02174,74,9134,0,9208,869558,470067,1339625,109000,24,320,240,221152,1.876
130.35667,"mpeg4",176,144,54590,12,27,1537,0,1564,64483,825054,889537,242000,15,1920,1080,87108,20.005
581.233,"h264",480,360,295979,30,310,17128,0,17438,10151572,11352574,21504146,242000,29.97,320,240,218932,3.464
426.945,"h264",1280,720,1064703,29,228,12567,0,12795,11297544,45523691,56821235,539000,15,176,144,219480,3.712
440.967,"h264",320,240,281642,30,236,12994,0,13230,2444863,13079542,15524405,3000000,25,480,360,219656,3.54
189.956,"flv",320,240,231296,29,97,5597,0,5694,580292,4911734,5492026,539000,29.97,1280,720,218664,2.6
217.518,"h264",480,360,83054,29,112,6408,0,6520,406683,1851539,2258222,56000,15,480,360,217080,0.748
316.95166,"mpeg4",176,144,55396,12,64,3739,0,3803,111850,2082902,2194752,5000000,12,320,240,165700,4.96
250.017,"h264",320,240,153059,29,128,7366,0,7494,856855,3926589,4783444,5000000,29.97,320,240,218664,2.904
906.5983,"mpeg4",176,144,56108,12,187,10692,0,10879,597549,5760936,6358485,3000000,25,1280,720,165668,13.265
37.011665,"h264",1280,720,2759449,29,21,1088,0,1109,1899633,10866846,12766479,3000000,29.97,640,480,219480,42.299
714.371,"vp8",1280,720,652356,29.981792,143,21264,0,21407,14532530,43720516,58253046,109000,25,1280,720,328312,21.849
273.816,"vp8",1920,1080,1571003,25.065933,77,6766,0,6843,6190779,47579961,53770740,242000,25,480,360,219656,6.212
440.967,"h264",320,240,281642,30,236,12994,0,13230,2444863,13079542,15524405,3000000,12,1920,1080,219656,3.752
163.897,"flv",320,240,267032,29,87,4826,0,4913,824159,4646573,5470732,5000000,24,176,144,219656,1.604
67.583336,"mpeg4",176,144,51225,12,15,777,0,792,47585,385164,432749,539000,29.97,1920,1080,219480,2.432
49.178333,"mpeg4",176,144,54338,7,10,334,0,344,33046,300986,334032,242000,24,176,144,221160,0.596
42.2,"h264",480,360,288705,25,23,1033,0,1056,216154,1306770,1522924,56000,25,640,480,216820,1.256
385.052,"vp8",1280,720,441862,23.979221,77,9155,0,9232,16244376,5023129,21267505,3000000,29.97,1920,1080,219480,14.605
33.09,"h264",320,240,279173,13,22,434,0,456,101794,1052937,1154731,242000,15,640,480,219480,6.448
254.922,"vp8",480,360,260667,30.062992,51,7585,0,7636,918325,7387906,8306231,3000000,24,320,240,221160,1.124
581.233,"h264",480,360,295979,30,310,17128,0,17438,10151572,11352574,21504146,109000,15,1920,1080,218932,20.697
326.583,"vp8",640,480,1055982,25.039877,102,8061,0,8163,1868804,41239444,43108248,5000000,29.97,640,480,213080,12.169
69.933,"flv",320,240,272898,15,37,1013,0,1050,349781,2035796,2385577,3000000,25,640,480,219656,5.108
581.233,"h264",480,360,295979,30,310,17128,0,17438,10151572,11352574,21504146,5000000,15,1280,720,218932,5.404
750.433,"vp8",1280,720,794075,13.482667,81,10031,0,10112,3852576,70635013,74487589,109000,15,320,240,165700,1.764
157.80167,"h264",1280,720,2885589,25,72,3873,0,3945,5611970,51306874,56918844,109000,29.97,320,240,216064,7.52
189.956,"flv",320,240,231296,29,97,5597,0,5694,580292,4911734,5492026,109000,12,1920,1080,637128,24.55
157.891,"h264",480,360,406908,29,87,4646,0,4733,1776729,6254165,8030894,820000,25,480,360,219464,3.728
127.221664,"h264",1920,1080,3080852,23,70,2980,0,3050,3818903,45174992,48993895,5000000,15,1920,1080,217544,9.117
290.01666,"mpeg4",176,144,52783,12,61,3417,0,3478,119325,1794184,1913509,5000000,29.97,1920,1080,135664,29.906
217.518,"h264",480,360,83054,29,112,6408,0,6520,406683,1851539,2258222,56000,25,1920,1080,216820,11.797
714.371,"vp8",1280,720,652356,29.981792,143,21264,0,21407,14532530,43720516,58253046,109000,24,1280,720,165044,4.012
33.09,"h264",320,240,279173,13,22,434,0,456,101794,1052937,1154731,56000,25,1920,1080,629176,50.475
34.168,"vp8",480,360,186895,30.029411,16,1005,0,1021,238485,559745,798230,242000,12,640,480,165700,4.48
326.583,"vp8",640,480,1055982,25.039877,102,8061,0,8163,1868804,41239444,43108248,5000000,15,640,480,212772,3.34
39.055,"h264",1920,1080,5992818,30,26,1144,0,1170,839251,28416939,29256190,3000000,29.97,1280,720,216020,10.833
80.536,"h264",480,360,690041,29,43,2374,0,2417,618732,6327913,6946645,242000,25,480,360,219480,4.088
217.518,"h264",480,360,83054,29,112,6408,0,6520,406683,1851539,2258222,109000,24,480,360,217080,0.836
42.2,"h264",480,360,288705,25,23,1033,0,1056,216154,1306770,1522924,242000,25,480,360,216820,4.476
204.938,"h264",480,360,297373,16,111,3169,0,3280,1451634,6166260,7617894,242000,29.97,480,360,83368,3.46
69.933,"flv",320,240,272898,15,37,1013,0,1050,349781,2035796,2385577,3000000,25,176,144,219656,4.62
1140.349,"vp8",1280,720,2394626,30.007017,328,33880,0,34208,20478926,320859863,341338789,56000,12,1280,720,219480,4.272
458.625,"h264",640,480,517364,29,245,13501,0,13746,5308581,24350943,29659524,3000000,15,640,480,216820,10.545
273.816,"vp8",1920,1080,1571003,25.065933,77,6766,0,6843,6190779,47579961,53770740,3000000,24,640,480,219656,35.914
80.536,"h264",480,360,690041,29,43,2374,0,2417,618732,6327913,6946645,242000,24,480,360,219480,11.877
906.5983,"mpeg4",176,144,56108,12,187,10692,0,10879,597549,5760936,6358485,5000000,29.97,320,240,165668,2.2
127.221664,"h264",1920,1080,3080852,23,70,2980,0,3050,3818903,45174992,48993895,56000,15,320,240,217348,7.852
1140.349,"vp8",1280,720,2394626,30.007017,328,33880,0,34208,20478926,320859863,341338789,539000,24,640,480,219480,21.797
176.901,"vp8",480,360,26968,25.113636,38,4382,0,4420,393395,202954,596349,56000,12,480,360,218932,1.356
645.84,"vp8",320,240,95903,25.032558,138,16008,0,16146,1081321,6660941,7742262,820000,25,640,480,219200,1.38
581.233,"h264",480,360,295979,30,310,17128,0,17438,10151572,11352574,21504146,242000,29.97,176,144,218932,1.02
326.583,"vp8",640,480,1055982,25.039877,102,8061,0,8163,1868804,41239444,43108248,56000,24,1920,1080,212772,31.63
326.58832,"h264",1920,1080,5999648,23,174,7656,0,7830,16603953,228322925,244926878,3000000,24,320,240,218932,21.205
43.827,"flv",320,240,272273,25,23,1081,0,1104,137210,1354404,1491614,5000000,29.97,1920,1080,218932,17.469
326.583,"vp8",640,480,1055982,25.039877,102,8061,0,8163,1868804,41239444,43108248,56000,29.97,1280,720,322384,22.849
143.03334,"mpeg4",176,144,51082,12,31,1685,0,1716,56405,856907,913312,56000,12,1280,720,219480,3.584
59.883,"vp8",1280,720,994960,30.38983,13,1780,0,1793,481774,6965881,7447655,820000,29.97,176,144,155028,4.032
33.09,"h264",320,240,279173,13,22,434,0,456,101794,1052937,1154731,820000,24,320,240,219480,3.152
127.221664,"h264",1920,1080,3080852,23,70,2980,0,3050,3818903,45174992,48993895,539000,12,176,144,217348,7.624
750.433,"vp8",1280,720,794075,13.482667,81,10031,0,10112,3852576,70635013,74487589,56000,15,480,360,165700,2.836
250.017,"h264",320,240,153059,29,128,7366,0,7494,856855,3926589,4783444,109000,15,320,240,218900,0.644
86.486,"h264",640,480,356037,29,46,2547,0,2593,819680,3029350,3849030,5000000,24,176,144,219656,2.008
379.32,"h264",480,360,181960,25,195,9289,0,9484,3392479,5235193,8627672,3000000,12,640,480,219480,3.564
426.945,"h264",1280,720,1064703,29,228,12567,0,12795,11297544,45523691,56821235,5000000,24,480,360,219480,4.116
43.827,"flv",320,240,272273,25,23,1081,0,1104,137210,1354404,1491614,539000,15,1920,1080,218932,4.568
379.32,"h264",480,360,181960,25,195,9289,0,9484,3392479,5235193,8627672,242000,15,640,480,219480,1.148
1140.349,"vp8",1280,720,2394626,30.007017,328,33880,0,34208,20478926,320859863,341338789,3000000,29.97,320,240,219480,3.872
43.827,"flv",320,240,272273,25,23,1081,0,1104,137210,1354404,1491614,539000,12,1920,1080,218932,22.697
74.535,"mpeg4",176,144,55305,12,15,879,0,894,23996,491276,515272,56000,12,320,240,219464,0.368
143.03334,"mpeg4",176,144,51082,12,31,1685,0,1716,56405,856907,913312,539000,29.97,1280,720,219480,11.561
106.765,"h264",1280,720,849586,25,66,2603,0,2669,4427240,6911026,11338266,5000000,15,1280,720,219480,4.716
98.683334,"mpeg4",176,144,55552,12,20,1164,0,1184,48267,636993,685260,242000,15,1280,720,217880,7.296
254.922,"vp8",480,360,260667,30.062992,51,7585,0,7636,918325,7387906,8306231,3000000,15,480,360,221160,14.029
110.966995,"h264",480,360,397112,30,59,3271,0,3330,529627,4978664,5508291,109000,15,1280,720,216820,2.576
384.451,"h264",640,480,646432,29,205,11318,0,11523,2839955,28225248,31065203,109000,29.97,480,360,217568,7.844
225.08,"h264",480,360,538452,25,113,5515,0,5628,1873408,13275961,15149369,539000,29.97,480,360,216820,13.213
274.541,"vp8",480,360,139791,30.029198,58,8170,0,8228,802625,3994697,4797322,3000000,24,640,480,216820,1.56
458.625,"h264",640,480,517364,29,245,13501,0,13746,5308581,24350943,29659524,242000,25,640,480,216820,7.736
256.20834,"mpeg4",176,144,57565,12,56,3018,0,3074,302900,1540700,1843600,56000,12,320,240,219480,0.808
368.32,"vp8",640,480,29096,25.02174,74,9134,0,9208,869558,470067,1339625,539000,15,640,480,221152,2.704
906.5983,"mpeg4",176,144,56108,12,187,10692,0,10879,597549,5760936,6358485,820000,25,640,480,165668,0.748
239.14166,"h264",480,360,500198,25,110,5868,0,5978,1406751,13545526,14952277,820000,24,1920,1080,113816,5.84
906.5983,"mpeg4",176,144,56108,12,187,10692,0,10879,597549,5760936,6358485,109000,24,1920,1080,165668,11.933
136.77,"flv",320,240,274433,29,73,4027,0,4100,402408,4289370,4691778,820000,24,480,360,90052,14.161
176.901,"vp8",480,360,26968,25.113636,38,4382,0,4420,393395,202954,596349,820000,12,1920,1080,218932,5.256
59.883,"vp8",1280,720,994960,30.38983,13,1780,0,1793,481774,6965881,7447655,539000,12,480,360,155028,5.82
581.233,"h264",480,360,295979,30,310,17128,0,17438,10151572,11352574,21504146,5000000,24,176,144,218932,4.004
143.03334,"mpeg4",176,144,51082,12,31,1685,0,1716,56405,856907,913312,5000000,24,176,144,219480,0.976
203.198,"flv",320,240,239336,29,104,5974,0,6078,853613,5225468,6079081,820000,24,176,144,221160,0.524
426.945,"h264",1280,720,1064703,29,228,12567,0,12795,11297544,45523691,56821235,5000000,12,320,240,219480,3.42
311.1,"mpeg4",176,144,56416,12,113,3620,0,3733,127552,2066350,2193902,820000,25,176,144,221160,0.28
189.956,"flv",320,240,231296,29,97,5597,0,5694,580292,4911734,5492026,109000,25,1920,1080,218664,26.646
473,"h264",320,240,164017,25,198,10924,704,11826,1419320,8047423,9697521,539000,25,176,144,220900,0.804
282.56,"h264",640,480,559834,25,145,6920,0,7065,4966509,14806840,19773349,820000,12,320,240,221152,2.064
311.1,"mpeg4",176,144,56416,12,113,3620,0,3733,127552,2066350,2193902,539000,24,176,144,221160,0.676
304.927,"vp8",320,240,134334,25.075659,82,7541,0,7623,833754,4286526,5120280,109000,25,1280,720,216820,15.429
69.933,"flv",320,240,272898,15,37,1013,0,1050,349781,2035796,2385577,109000,15,640,480,219656,2.724
326.583,"vp8",640,480,1055982,25.039877,102,8061,0,8163,1868804,41239444,43108248,5000000,24,320,240,215124,1.264
906.5983,"mpeg4",176,144,56108,12,187,10692,0,10879,597549,5760936,6358485,539000,15,1280,720,317416,25.426
458.625,"h264",640,480,517364,29,245,13501,0,13746,5308581,24350943,29659524,5000000,29.97,320,240,216820,1.464
254.922,"vp8",480,360,260667,30.062992,51,7585,0,7636,918325,7387906,8306231,5000000,29.97,640,480,221160,6.18
63.667,"h264",640,480,972572,15,33,923,0,956,1259657,6480438,7740095,539000,25,1280,720,219656,22.649
130.35667,"mpeg4",176,144,54590,12,27,1537,0,1564,64483,825054,889537,109000,25,480,360,29244,1.96
1768.9417,"mpeg4",176,144,56152,12,354,20873,0,21227,1382103,11034284,12416387,109000,24,320,240,228952,0.384
222.53334,"h264",480,360,500449,30,219,6457,0,6676,2821722,11099102,13920824,109000,15,1280,720,217348,2.196
110.966995,"h264",480,360,397112,30,59,3271,0,3330,529627,4978664,5508291,242000,24,480,360,216820,1.132
177.33333,"mpeg4",176,144,53707,12,37,2091,0,2128,100969,1089548,1190517,539000,12,480,360,163024,1.332
157.891,"h264",480,360,406908,29,87,4646,0,4733,1776729,6254165,8030894,820000,25,176,144,219464,2.076
222.53334,"h264",480,360,500449,30,219,6457,0,6676,2821722,11099102,13920824,109000,15,640,480,217332,2.312
106.765,"h264",1280,720,849586,25,66,2603,0,2669,4427240,6911026,11338266,539000,24,320,240,219480,6.684
645.84,"vp8",320,240,95903,25.032558,138,16008,0,16146,1081321,6660941,7742262,109000,24,480,360,218932,3.02
203.198,"flv",320,240,239336,29,104,5974,0,6078,853613,5225468,6079081,539000,29.97,176,144,221160,3.992
63.667,"h264",640,480,972572,15,33,923,0,956,1259657,6480438,7740095,539000,29.97,176,144,219656,2.424
204.938,"h264",480,360,297373,16,111,3169,0,3280,1451634,6166260,7617894,3000000,24,320,240,93532,4.884
581.233,"h264",480,360,295979,30,310,17128,0,17438,10151572,11352574,21504146,5000000,25,176,144,218932,2.124
326.583,"vp8",640,480,1055982,25.039877,102,8061,0,8163,1868804,41239444,43108248,56000,24,176,144,215428,2.852
74.535,"mpeg4",176,144,55305,12,15,879,0,894,23996,491276,515272,242000,24,480,360,219464,5.984
473,"h264",320,240,164017,25,198,10924,704,11826,1419320,8047423,9697521,3000000,15,320,240,220900,7.08
311.1,"mpeg4",176,144,56416,12,113,3620,0,3733,127552,2066350,2193902,109000,15,480,360,221160,1.352
107.443,"vp8",480,360,320011,30.093458,30,3190,0,3220,671936,3625932,4297868,820000,24,640,480,216820,1.6
130.35667,"mpeg4",176,144,54590,12,27,1537,0,1564,64483,825054,889537,820000,25,640,480,34308,2.844
385.052,"vp8",1280,720,441862,23.979221,77,9155,0,9232,16244376,5023129,21267505,820000,15,320,240,219480,2.616
379.32,"h264",480,360,181960,25,195,9289,0,9484,3392479,5235193,8627672,242000,29.97,480,360,219480,6.728
384.451,"h264",640,480,646432,29,205,11318,0,11523,2839955,28225248,31065203,5000000,29.97,1280,720,217568,13.397
52.68,"h264",480,360,372001,25,53,1265,0,1318,870136,1579497,2449633,5000000,24,480,360,155028,1.56
391.08,"h264",640,480,230847,25,209,9569,0,9778,9023743,2261252,11284995,56000,24,1920,1080,219480,29.05
255.28,"flv",320,240,250276,25,110,6272,0,6382,611474,7374864,7986338,5000000,25,1280,720,216820,3.592
143.03334,"mpeg4",176,144,51082,12,31,1685,0,1716,56405,856907,913312,3000000,25,640,480,219480,0.956
750.433,"vp8",1280,720,794075,13.482667,81,10031,0,10112,3852576,70635013,74487589,539000,25,320,240,165700,3.34
292.092,"h264",480,360,480125,29,156,8599,0,8755,2375028,15155062,17530090,109000,25,1920,1080,219480,36.526
157.891,"h264",480,360,406908,29,87,4646,0,4733,1776729,6254165,8030894,539000,25,1920,1080,219464,13.685
80.536,"h264",480,360,690041,29,43,2374,0,2417,618732,6327913,6946645,3000000,24,1280,720,219480,4.068
326.58832,"h264",1920,1080,5999648,23,174,7656,0,7830,16603953,228322925,244926878,242000,25,480,360,218932,18.317
42.2,"h264",480,360,288705,25,23,1033,0,1056,216154,1306770,1522924,3000000,15,480,360,216820,0.832
225.08,"h264",480,360,538452,25,113,5515,0,5628,1873408,13275961,15149369,820000,15,1920,1080,216820,22.889
216.55,"h264",320,240,291150,29,112,6379,0,6491,1789334,6091735,7881069,56000,12,480,360,210024,3.052
274.541,"vp8",480,360,139791,30.029198,58,8170,0,8228,802625,3994697,4797322,539000,12,320,240,216064,1.6
130.35667,"mpeg4",176,144,54590,12,27,1537,0,1564,64483,825054,889537,109000,12,480,360,38528,3.408
581.233,"h264",480,360,295979,30,310,17128,0,17438,10151572,11352574,21504146,56000,24,1920,1080,218932,27.026
448.575,"vp8",1280,720,2052426,30.002232,92,13349,0,13441,9132637,105950761,115083398,3000000,25,1280,720,217080,5.532
1140.349,"vp8",1280,720,2394626,30.007017,328,33880,0,34208,20478926,320859863,341338789,539000,24,480,360,219480,5.332
395.44,"vp8",1280,720,1611942,25.027847,80,9806,0,9886,5073258,74605061,79678319,109000,25,480,360,221160,4.944
476.957,"vp8",1280,720,1387100,30.05252,105,14200,0,14305,3487520,79210885,82698405,5000000,29.97,640,480,165700,3.764
69.93833,"mpeg4",176,144,56717,12,14,825,0,839,47521,448322,495843,820000,24,176,144,221152,0.788
316.95166,"mpeg4",176,144,55396,12,64,3739,0,3803,111850,2082902,2194752,820000,29.97,320,240,165700,0.428
326.58832,"h264",1920,1080,5999648,23,174,7656,0,7830,16603953,228322925,244926878,820000,25,480,360,218932,9.193
69.933,"flv",320,240,272898,15,37,1013,0,1050,349781,2035796,2385577,539000,12,1280,720,219656,1.548
216.55,"h264",320,240,291150,29,112,6379,0,6491,1789334,6091735,7881069,109000,24,480,360,191436,4.292
440.967,"h264",320,240,281642,30,236,12994,0,13230,2444863,13079542,15524405,820000,29.97,176,144,219656,2.26
384.451,"h264",640,480,646432,29,205,11318,0,11523,2839955,28225248,31065203,3000000,25,1920,1080,217568,48.943
130.35667,"mpeg4",176,144,54590,12,27,1537,0,1564,64483,825054,889537,3000000,12,176,144,33508,0.576
250.017,"h264",320,240,153059,29,128,7366,0,7494,856855,3926589,4783444,242000,29.97,320,240,218664,3.34
52.68,"h264",480,360,372001,25,53,1265,0,1318,870136,1579497,2449633,3000000,12,1280,720,320852,54.191
311.1,"mpeg4",176,144,56416,12,113,3620,0,3733,127552,2066350,2193902,56000,12,320,240,221160,0.344
163.897,"flv",320,240,267032,29,87,4826,0,4913,824159,4646573,5470732,5000000,29.97,1280,720,311396,70.428
98.683334,"mpeg4",176,144,55552,12,20,1164,0,1184,48267,636993,685260,820000,29.97,1920,1080,217880,15.773
645.84,"vp8",320,240,95903,25.032558,138,16008,0,16146,1081321,6660941,7742262,539000,29.97,176,144,218932,2.124
250.017,"h264",320,240,153059,29,128,7366,0,7494,856855,3926589,4783444,539000,12,1280,720,317840,23.321
127.221664,"h264",1920,1080,3080852,23,70,2980,0,3050,3818903,45174992,48993895,3000000,25,320,240,217436,10.025
292.092,"h264",480,360,480125,29,156,8599,0,8755,2375028,15155062,17530090,56000,29.97,320,240,219480,1.384
110.966995,"h264",480,360,397112,30,59,3271,0,3330,529627,4978664,5508291,539000,25,176,144,216820,4.656
581.233,"h264",480,360,295979,30,310,17128,0,17438,10151572,11352574,21504146,56000,12,176,144,218932,1.412
42.2,"h264",480,360,288705,25,23,1033,0,1056,216154,1306770,1522924,539000,25,176,144,216820,0.792
131.76,"vp8",640,480,104723,25.145039,37,3257,0,3294,945865,778937,1724802,109000,25,480,360,221152,1.104
452.689,"vp8",320,240,66680,5.7057524,42,2537,0,2579,207037,3566163,3773200,820000,29.97,1280,720,247884,10.409
311.1,"mpeg4",176,144,56416,12,113,3620,0,3733,127552,2066350,2193902,820000,15,1280,720,311108,18.453
163.897,"flv",320,240,267032,29,87,4826,0,4913,824159,4646573,5470732,56000,25,176,144,219656,1.744
204.938,"h264",480,360,297373,16,111,3169,0,3280,1451634,6166260,7617894,109000,12,1280,720,82976,8.253
225.08,"h264",480,360,538452,25,113,5515,0,5628,1873408,13275961,15149369,242000,24,176,144,216820,3.212
69.933,"flv",320,240,272898,15,37,1013,0,1050,349781,2035796,2385577,56000,15,176,144,219656,1.436
189.956,"flv",320,240,231296,29,97,5597,0,5694,580292,4911734,5492026,109000,12,640,480,218664,0.756
395.44,"vp8",1280,720,1611942,25.027847,80,9806,0,9886,5073258,74605061,79678319,820000,25,1280,720,221160,13.173
340.424,"flv",320,240,244491,11,69,4012,0,4081,1168939,9234909,10403848,109000,12,176,144,221152,0.324
458.625,"h264",640,480,517364,29,245,13501,0,13746,5308581,24350943,29659524,109000,25,640,480,216820,1.496
311.1,"mpeg4",176,144,56416,12,113,3620,0,3733,127552,2066350,2193902,109000,29.97,640,480,221160,0.544
581.233,"h264",480,360,295979,30,310,17128,0,17438,10151572,11352574,21504146,5000000,15,640,480,218932,21.285
131.76,"vp8",640,480,104723,25.145039,37,3257,0,3294,945865,778937,1724802,820000,15,1280,720,221152,2.044
95.462,"h264",640,480,809256,29,51,2811,0,2862,886496,8770159,9656655,3000000,12,640,480,221160,3.084
1768.9417,"mpeg4",176,144,56152,12,354,20873,0,21227,1382103,11034284,12416387,3000000,15,320,240,223904,3.18
77.233,"h264",480,360,382461,30,53,2265,0,2318,182297,3510033,3692330,109000,25,640,480,219480,6.94
86.486,"h264",640,480,356037,29,46,2547,0,2593,819680,3029350,3849030,820000,24,176,144,219656,2.78
326.58832,"h264",1920,1080,5999648,23,174,7656,0,7830,16603953,228322925,244926878,539000,12,176,144,218932,8.429
368.32,"vp8",640,480,29096,25.02174,74,9134,0,9208,869558,470067,1339625,539000,12,1280,720,221152,3.008
581.233,"h264",480,360,295979,30,310,17128,0,17438,10151572,11352574,21504146,539000,24,1280,720,323148,34.018
216.55,"h264",320,240,291150,29,112,6379,0,6491,1789334,6091735,7881069,3000000,29.97,480,360,186700,4.252
581.233,"h264",480,360,295979,30,310,17128,0,17438,10151572,11352574,21504146,539000,15,640,480,218932,1.48
131.76,"vp8",640,480,104723,25.145039,37,3257,0,3294,945865,778937,1724802,539000,29.97,320,240,221152,2.264
395.44,"vp8",1280,720,1611942,25.027847,80,9806,0,9886,5073258,74605061,79678319,56000,15,1280,720,221160,10.713
270.655,"vp8",640,480,652967,30.062963,89,8028,0,8117,1912240,20178890,22091130,109000,24,640,480,219480,1.964
290.01666,"mpeg4",176,144,52783,12,61,3417,0,3478,119325,1794184,1913509,5000000,12,1280,720,136256,1.988
167.39166,"h264",1280,720,2207484,24,86,3931,0,4017,4369420,41819887,46189307,820000,12,176,144,219656,4.076
256.20834,"mpeg4",176,144,57565,12,56,3018,0,3074,302900,1540700,1843600,5000000,15,176,144,219480,1.384
52.68,"h264",480,360,372001,25,53,1265,0,1318,870136,1579497,2449633,109000,12,1280,720,140080,10.325
225.08,"h264",480,360,538452,25,113,5515,0,5628,1873408,13275961,15149369,3000000,25,480,360,216820,1.22
222.53334,"h264",480,360,500449,30,219,6457,0,6676,2821722,11099102,13920824,539000,24,176,144,217348,0.904
203.198,"flv",320,240,239336,29,104,5974,0,6078,853613,5225468,6079081,820000,29.97,480,360,221160,8.441
476.957,"vp8",1280,720,1387100,30.05252,105,14200,0,14305,3487520,79210885,82698405,539000,24,480,360,165700,7.368
339.667,"h264",640,480,257699,30,181,10010,0,10191,10121223,820261,10941484,539000,25,640,480,219480,8.165
473,"h264",320,240,164017,25,198,10924,704,11826,1419320,8047423,9697521,3000000,25,1280,720,220900,3.46
106.765,"h264",1280,720,849586,25,66,2603,0,2669,4427240,6911026,11338266,539000,29.97,1920,1080,219480,37.53
274.541,"vp8",480,360,139791,30.029198,58,8170,0,8228,802625,3994697,4797322,5000000,25,1280,720,216820,3.244
157.80167,"h264",1280,720,2885589,25,72,3873,0,3945,5611970,51306874,56918844,5000000,29.97,480,360,216064,4.096
167.39166,"h264",1280,720,2207484,24,86,3931,0,4017,4369420,41819887,46189307,242000,25,320,240,219656,3.664
860.056,"vp8",1280,720,2688309,29.968605,277,25496,0,25773,12989828,276022270,289012098,56000,29.97,480,360,257132,5.376
290.01666,"mpeg4",176,144,52783,12,61,3417,0,3478,119325,1794184,1913509,109000,25,480,360,136020,0.52
440.967,"h264",320,240,281642,30,236,12994,0,13230,2444863,13079542,15524405,56000,12,480,360,219656,1.908
177.33333,"mpeg4",176,144,53707,12,37,2091,0,2128,100969,1089548,1190517,109000,12,176,144,163024,0.972
189.956,"flv",320,240,231296,29,97,5597,0,5694,580292,4911734,5492026,242000,15,176,144,218664,0.964
42.2,"h264",480,360,288705,25,23,1033,0,1056,216154,1306770,1522924,5000000,25,1280,720,216820,2.988
286.995,"h264",480,360,508160,23,156,6726,0,6882,2285153,15944803,18229956,109000,12,1920,1080,216820,6.872
157.80167,"h264",1280,720,2885589,25,72,3873,0,3945,5611970,51306874,56918844,109000,24,1920,1080,216056,7.88
110.966995,"h264",480,360,397112,30,59,3271,0,3330,529627,4978664,5508291,3000000,24,480,360,216820,21.593
37.011665,"h264",1280,720,2759449,29,21,1088,0,1109,1899633,10866846,12766479,56000,24,1920,1080,219480,45.123
106.765,"h264",1280,720,849586,25,66,2603,0,2669,4427240,6911026,11338266,820000,24,480,360,219480,6.344
290.01666,"mpeg4",176,144,52783,12,61,3417,0,3478,119325,1794184,1913509,820000,15,1920,1080,133404,24.338
59.883,"vp8",1280,720,994960,30.38983,13,1780,0,1793,481774,6965881,7447655,242000,29.97,1280,720,320140,29.57
286.995,"h264",480,360,508160,23,156,6726,0,6882,2285153,15944803,18229956,820000,25,1920,1080,216820,14.505
67.583336,"mpeg4",176,144,51225,12,15,777,0,792,47585,385164,432749,242000,15,176,144,219480,0.304
426.945,"h264",1280,720,1064703,29,228,12567,0,12795,11297544,45523691,56821235,820000,24,1920,1080,219480,12.537
426.945,"h264",1280,720,1064703,29,228,12567,0,12795,11297544,45523691,56821235,820000,15,176,144,219480,3.724
292.092,"h264",480,360,480125,29,156,8599,0,8755,2375028,15155062,17530090,242000,25,1280,720,219480,20.521
250.017,"h264",320,240,153059,29,128,7366,0,7494,856855,3926589,4783444,56000,12,480,360,218664,2.752
311.1,"mpeg4",176,144,56416,12,113,3620,0,3733,127552,2066350,2193902,3000000,12,640,480,221160,1.644
581.233,"h264",480,360,295979,30,310,17128,0,17438,10151572,11352574,21504146,820000,15,640,480,218932,13.649
222.53334,"h264",480,360,500449,30,219,6457,0,6676,2821722,11099102,13920824,242000,24,480,360,217348,7.764
67.583336,"mpeg4",176,144,51225,12,15,777,0,792,47585,385164,432749,539000,12,640,480,219480,9.353
714.371,"vp8",1280,720,652356,29.981792,143,21264,0,21407,14532530,43720516,58253046,109000,29.97,1280,720,165232,4.264
239.14166,"h264",480,360,500198,25,110,5868,0,5978,1406751,13545526,14952277,5000000,29.97,1280,720,116544,4.224
326.58832,"h264",1920,1080,5999648,23,174,7656,0,7830,16603953,228322925,244926878,242000,25,1920,1080,218932,10.549
368.32,"vp8",640,480,29096,25.02174,74,9134,0,9208,869558,470067,1339625,3000000,29.97,176,144,221152,0.792
270.655,"vp8",640,480,652967,30.062963,89,8028,0,8117,1912240,20178890,22091130,3000000,12,1280,720,219480,22.577
67.583336,"mpeg4",176,144,51225,12,15,777,0,792,47585,385164,432749,820000,24,480,360,219480,2.156
49.178333,"mpeg4",176,144,54338,7,10,334,0,344,33046,300986,334032,539000,15,1280,720,221160,5.14
448.575,"vp8",1280,720,2052426,30.002232,92,13349,0,13441,9132637,105950761,115083398,109000,24,1920,1080,217080,8.901
95.462,"h264",640,480,809256,29,51,2811,0,2862,886496,8770159,9656655,5000000,25,320,240,221160,1.728
109.92167,"mpeg4",176,144,54002,12,22,1297,0,1319,46221,695782,742003,820000,12,1920,1080,87116,24.582
316.95166,"mpeg4",176,144,55396,12,64,3739,0,3803,111850,2082902,2194752,3000000,24,1920,1080,165700,11.541
95.462,"h264",640,480,809256,29,51,2811,0,2862,886496,8770159,9656655,56000,24,1280,720,221160,7.924
379.32,"h264",480,360,181960,25,195,9289,0,9484,3392479,5235193,8627672,242000,24,1280,720,219480,2.524
80.536,"h264",480,360,690041,29,43,2374,0,2417,618732,6327913,6946645,5000000,12,480,360,219480,18.797
177.33333,"mpeg4",176,144,53707,12,37,2091,0,2128,100969,1089548,1190517,3000000,12,320,240,163024,1.068
385.052,"vp8",1280,720,441862,23.979221,77,9155,0,9232,16244376,5023129,21267505,242000,25,640,480,219480,4.72
176.901,"vp8",480,360,26968,25.113636,38,4382,0,4420,393395,202954,596349,3000000,15,176,144,218932,0.856
391.08,"h264",640,480,230847,25,209,9569,0,9778,9023743,2261252,11284995,56000,29.97,480,360,219480,4.988
384.451,"h264",640,480,646432,29,205,11318,0,11523,2839955,28225248,31065203,109000,15,640,480,217544,2.956
473,"h264",320,240,164017,25,198,10924,704,11826,1419320,8047423,9697521,242000,15,1920,1080,644224,35.55
77.233,"h264",480,360,382461,30,53,2265,0,2318,182297,3510033,3692330,539000,15,640,480,219480,1.48
80.536,"h264",480,360,690041,29,43,2374,0,2417,618732,6327913,6946645,820000,15,480,360,219480,1.672
274.541,"vp8",480,360,139791,30.029198,58,8170,0,8228,802625,3994697,4797322,3000000,25,480,360,216820,12.561
176.901,"vp8",480,360,26968,25.113636,38,4382,0,4420,393395,202954,596349,56000,15,320,240,218932,1.072
69.93833,"mpeg4",176,144,56717,12,14,825,0,839,47521,448322,495843,109000,12,1920,1080,221152,6.188
34.168,"vp8",480,360,186895,30.029411,16,1005,0,1021,238485,559745,798230,242000,15,640,480,165700,7.164
52.68,"h264",480,360,372001,25,53,1265,0,1318,870136,1579497,2449633,820000,15,480,360,140080,6.2
143.03334,"mpeg4",176,144,51082,12,31,1685,0,1716,56405,856907,913312,3000000,12,1920,1080,219480,3.324
222.53334,"h264",480,360,500449,30,219,6457,0,6676,2821722,11099102,13920824,242000,15,1920,1080,646252,33.638
714.371,"vp8",1280,720,652356,29.981792,143,21264,0,21407,14532530,43720516,58253046,109000,15,480,360,164988,3.256
379.32,"h264",480,360,181960,25,195,9289,0,9484,3392479,5235193,8627672,539000,24,320,240,219480,2.372
490.6,"h264",480,360,300437,25,256,12010,0,12266,1448177,16976151,18424328,539000,12,640,480,219480,10.357
107.443,"vp8",480,360,320011,30.093458,30,3190,0,3220,671936,3625932,4297868,3000000,25,1920,1080,216820,46.223
63.667,"h264",640,480,972572,15,33,923,0,956,1259657,6480438,7740095,242000,24,640,480,219656,12.517
163.897,"flv",320,240,267032,29,87,4826,0,4913,824159,4646573,5470732,56000,15,320,240,219656,1.932
63.667,"h264",640,480,972572,15,33,923,0,956,1259657,6480438,7740095,539000,15,320,240,219656,6.204
906.5983,"mpeg4",176,144,56108,12,187,10692,0,10879,597549,5760936,6358485,109000,24,640,480,165668,4.396
98.683334,"mpeg4",176,144,55552,12,20,1164,0,1184,48267,636993,685260,56000,12,176,144,217880,0.272
339.667,"h264",640,480,257699,30,181,10010,0,10191,10121223,820261,10941484,56000,29.97,176,144,219480,1.136
130.35667,"mpeg4",176,144,54590,12,27,1537,0,1564,64483,825054,889537,109000,15,640,480,135796,6.952
316.95166,"mpeg4",176,144,55396,12,64,3739,0,3803,111850,2082902,2194752,539000,24,320,240,165700,4.396
326.583,"vp8",640,480,1055982,25.039877,102,8061,0,8163,1868804,41239444,43108248,820000,15,1920,1080,212880,26.274
98.683334,"mpeg4",176,144,55552,12,20,1164,0,1184,48267,636993,685260,5000000,12,640,480,217864,1.452
379.32,"h264",480,360,181960,25,195,9289,0,9484,3392479,5235193,8627672,56000,25,176,144,219464,1.676
64.933,"flv",320,240,236793,15,39,936,0,975,318954,1603007,1921961,5000000,25,176,144,217080,0.376
339.667,"h264",640,480,257699,30,181,10010,0,10191,10121223,820261,10941484,56000,25,320,240,219480,1.22
95.462,"h264",640,480,809256,29,51,2811,0,2862,886496,8770159,9656655,242000,15,1280,720,221160,2.92
292.092,"h264",480,360,480125,29,156,8599,0,8755,2375028,15155062,17530090,820000,12,320,240,219480,3.792
239.14166,"h264",480,360,500198,25,110,5868,0,5978,1406751,13545526,14952277,3000000,25,480,360,105196,6.388
326.58832,"h264",1920,1080,5999648,23,174,7656,0,7830,16603953,228322925,244926878,539000,29.97,1280,720,218932,9.277
43.827,"flv",320,240,272273,25,23,1081,0,1104,137210,1354404,1491614,539000,12,320,240,218932,4.604
77.233,"h264",480,360,382461,30,53,2265,0,2318,182297,3510033,3692330,242000,15,1920,1080,219480,4.512
426.945,"h264",1280,720,1064703,29,228,12567,0,12795,11297544,45523691,56821235,820000,15,320,240,219480,4.92
106.765,"h264",1280,720,849586,25,66,2603,0,2669,4427240,6911026,11338266,56000,29.97,640,480,219480,2.896
69.93833,"mpeg4",176,144,56717,12,14,825,0,839,47521,448322,495843,5000000,12,320,240,221152,0.396
131.76,"vp8",640,480,104723,25.145039,37,3257,0,3294,945865,778937,1724802,56000,29.97,320,240,221152,0.852
286.995,"h264",480,360,508160,23,156,6726,0,6882,2285153,15944803,18229956,3000000,25,176,144,216820,6.236
326.583,"vp8",640,480,1055982,25.039877,102,8061,0,8163,1868804,41239444,43108248,3000000,24,640,480,215712,28.198
80.536,"h264",480,360,690041,29,43,2374,0,2417,618732,6327913,6946645,109000,25,640,480,219480,13.577
157.80167,"h264",1280,720,2885589,25,72,3873,0,3945,5611970,51306874,56918844,56000,29.97,1920,1080,216020,44.199
33.09,"h264",320,240,279173,13,22,434,0,456,101794,1052937,1154731,5000000,24,1280,720,219480,2.616
157.891,"h264",480,360,406908,29,87,4646,0,4733,1776729,6254165,8030894,5000000,29.97,480,360,219464,13.209
33.09,"h264",320,240,279173,13,22,434,0,456,101794,1052937,1154731,242000,29.97,176,144,219480,0.592
77.233,"h264",480,360,382461,30,53,2265,0,2318,182297,3510033,3692330,539000,29.97,1920,1080,219480,17.389
95.462,"h264",640,480,809256,29,51,2811,0,2862,886496,8770159,9656655,242000,24,480,360,221160,1.876
69.93833,"mpeg4",176,144,56717,12,14,825,0,839,47521,448322,495843,56000,24,320,240,221152,0.348
49.178333,"mpeg4",176,144,54338,7,10,334,0,344,33046,300986,334032,5000000,29.97,480,360,221160,1.38
42.2,"h264",480,360,288705,25,23,1033,0,1056,216154,1306770,1522924,5000000,24,176,144,216820,2.088
95.462,"h264",640,480,809256,29,51,2811,0,2862,886496,8770159,9656655,56000,24,1920,1080,221160,34.722
270.655,"vp8",640,480,652967,30.062963,89,8028,0,8117,1912240,20178890,22091130,539000,25,176,144,219480,4.852
581.233,"h264",480,360,295979,30,310,17128,0,17438,10151572,11352574,21504146,242000,15,480,360,218932,1.04
292.092,"h264",480,360,480125,29,156,8599,0,8755,2375028,15155062,17530090,3000000,29.97,480,360,219480,5.664
34.168,"vp8",480,360,186895,30.029411,16,1005,0,1021,238485,559745,798230,109000,29.97,320,240,165700,2.756
98.683334,"mpeg4",176,144,55552,12,20,1164,0,1184,48267,636993,685260,539000,12,320,240,218136,2.012
95.462,"h264",640,480,809256,29,51,2811,0,2862,886496,8770159,9656655,5000000,24,640,480,221160,11.513
49.178333,"mpeg4",176,144,54338,7,10,334,0,344,33046,300986,334032,539000,29.97,640,480,221160,0.476
127.221664,"h264",1920,1080,3080852,23,70,2980,0,3050,3818903,45174992,48993895,56000,15,1280,720,217348,9.469
304.927,"vp8",320,240,134334,25.075659,82,7541,0,7623,833754,4286526,5120280,820000,15,1280,720,216820,4.664
448.575,"vp8",1280,720,2052426,30.002232,92,13349,0,13441,9132637,105950761,115083398,109000,29.97,320,240,217080,8.765
250.017,"h264",320,240,153059,29,128,7366,0,7494,856855,3926589,4783444,56000,24,320,240,218664,2.348
254.922,"vp8",480,360,260667,30.062992,51,7585,0,7636,918325,7387906,8306231,109000,12,1280,720,221160,8.417
37.011665,"h264",1280,720,2759449,29,21,1088,0,1109,1899633,10866846,12766479,5000000,24,1280,720,219480,6.724
385.052,"vp8",1280,720,441862,23.979221,77,9155,0,9232,16244376,5023129,21267505,820000,15,176,144,219480,1.808
452.689,"vp8",320,240,66680,5.7057524,42,2537,0,2579,207037,3566163,3773200,5000000,25,1920,1080,646316,145.421
189.956,"flv",320,240,231296,29,97,5597,0,5694,580292,4911734,5492026,5000000,15,1920,1080,218664,21.237
52.68,"h264",480,360,372001,25,53,1265,0,1318,870136,1579497,2449633,5000000,25,1920,1080,140080,15.541
225.08,"h264",480,360,538452,25,113,5515,0,5628,1873408,13275961,15149369,539000,25,1920,1080,216820,5.08
326.58832,"h264",1920,1080,5999648,23,174,7656,0,7830,16603953,228322925,244926878,109000,12,480,360,218932,8.773
906.5983,"mpeg4",176,144,56108,12,187,10692,0,10879,597549,5760936,6358485,3000000,15,176,144,165668,0.312
316.95166,"mpeg4",176,144,55396,12,64,3739,0,3803,111850,2082902,2194752,242000,15,480,360,165700,6.024
222.53334,"h264",480,360,500449,30,219,6457,0,6676,2821722,11099102,13920824,5000000,25,640,480,217348,8.613
292.092,"h264",480,360,480125,29,156,8599,0,8755,2375028,15155062,17530090,242000,25,640,480,219480,1.936
176.901,"vp8",480,360,26968,25.113636,38,4382,0,4420,393395,202954,596349,539000,15,1920,1080,218932,6.236
157.891,"h264",480,360,406908,29,87,4646,0,4733,1776729,6254165,8030894,242000,25,320,240,219464,1.06
43.827,"flv",320,240,272273,25,23,1081,0,1104,137210,1354404,1491614,109000,25,640,480,218932,8.013
256.20834,"mpeg4",176,144,57565,12,56,3018,0,3074,302900,1540700,1843600,242000,25,1920,1080,219480,11.301
39.055,"h264",1920,1080,5992818,30,26,1144,0,1170,839251,28416939,29256190,5000000,25,640,480,216020,9.397
292.092,"h264",480,360,480125,29,156,8599,0,8755,2375028,15155062,17530090,109000,24,640,480,219480,1.796
59.883,"vp8",1280,720,994960,30.38983,13,1780,0,1793,481774,6965881,7447655,539000,15,320,240,155028,3.54
176.901,"vp8",480,360,26968,25.113636,38,4382,0,4420,393395,202954,596349,820000,29.97,480,360,218932,2.44
106.765,"h264",1280,720,849586,25,66,2603,0,2669,4427240,6911026,11338266,539000,24,1280,720,219480,5.648
239.14166,"h264",480,360,500198,25,110,5868,0,5978,1406751,13545526,14952277,5000000,25,320,240,116188,1.424
42.2,"h264",480,360,288705,25,23,1033,0,1056,216154,1306770,1522924,242000,29.97,480,360,216820,4.508
1768.9417,"mpeg4",176,144,56152,12,354,20873,0,21227,1382103,11034284,12416387,56000,15,320,240,227600,0.388
906.5983,"mpeg4",176,144,56108,12,187,10692,0,10879,597549,5760936,6358485,109000,12,640,480,165668,0.648
340.424,"flv",320,240,244491,11,69,4012,0,4081,1168939,9234909,10403848,56000,12,1280,720,221152,7.696
426.945,"h264",1280,720,1064703,29,228,12567,0,12795,11297544,45523691,56821235,56000,12,640,480,219480,6.828
69.933,"flv",320,240,272898,15,37,1013,0,1050,349781,2035796,2385577,56000,15,176,144,219656,0.372
385.052,"vp8",1280,720,441862,23.979221,77,9155,0,9232,16244376,5023129,21267505,820000,25,1920,1080,219480,32.934
326.583,"vp8",640,480,1055982,25.039877,102,8061,0,8163,1868804,41239444,43108248,3000000,12,640,480,215712,20.797
274.541,"vp8",480,360,139791,30.029198,58,8170,0,8228,802625,3994697,4797322,109000,29.97,640,480,216064,5.044
391.08,"h264",640,480,230847,25,209,9569,0,9778,9023743,2261252,11284995,56000,29.97,320,240,219480,0.988
130.35667,"mpeg4",176,144,54590,12,27,1537,0,1564,64483,825054,889537,242000,25,480,360,53464,0.524
176.901,"vp8",480,360,26968,25.113636,38,4382,0,4420,393395,202954,596349,820000,24,480,360,218932,0.672
217.518,"h264",480,360,83054,29,112,6408,0,6520,406683,1851539,2258222,56000,29.97,320,240,217080,2.452
64.933,"flv",320,240,236793,15,39,936,0,975,318954,1603007,1921961,242000,12,176,144,217080,1.048
37.011665,"h264",1280,720,2759449,29,21,1088,0,1109,1899633,10866846,12766479,109000,29.97,1920,1080,219480,54.475
63.667,"h264",640,480,972572,15,33,923,0,956,1259657,6480438,7740095,56000,12,1920,1080,219656,27.33
239.14166,"h264",480,360,500198,25,110,5868,0,5978,1406751,13545526,14952277,3000000,15,480,360,104584,4.908
52.68,"h264",480,360,372001,25,53,1265,0,1318,870136,1579497,2449633,820000,29.97,1920,1080,155028,6.384
581.233,"h264",480,360,295979,30,310,17128,0,17438,10151572,11352574,21504146,242000,24,640,480,218932,8.293
69.93833,"mpeg4",176,144,56717,12,14,825,0,839,47521,448322,495843,242000,24,1280,720,221152,1.196
714.371,"vp8",1280,720,652356,29.981792,143,21264,0,21407,14532530,43720516,58253046,539000,12,640,480,164888,8.573
254.922,"vp8",480,360,260667,30.062992,51,7585,0,7636,918325,7387906,8306231,3000000,24,480,360,221160,1.216
311.1,"mpeg4",176,144,56416,12,113,3620,0,3733,127552,2066350,2193902,5000000,24,320,240,221160,1.244
189.956,"flv",320,240,231296,29,97,5597,0,5694,580292,4911734,5492026,109000,15,176,144,218664,0.928
163.897,"flv",320,240,267032,29,87,4826,0,4913,824159,4646573,5470732,539000,25,320,240,219656,2.856
581.233,"h264",480,360,295979,30,310,17128,0,17438,10151572,11352574,21504146,242000,15,176,144,218932,1.804
750.433,"vp8",1280,720,794075,13.482667,81,10031,0,10112,3852576,70635013,74487589,539000,25,1280,720,165700,15.209
256.20834,"mpeg4",176,144,57565,12,56,3018,0,3074,302900,1540700,1843600,820000,12,480,360,219480,0.532
189.956,"flv",320,240,231296,29,97,5597,0,5694,580292,4911734,5492026,109000,15,176,144,218192,1.26
42.2,"h264",480,360,288705,25,23,1033,0,1056,216154,1306770,1522924,5000000,29.97,176,144,216820,1.568
189.956,"flv",320,240,231296,29,97,5597,0,5694,580292,4911734,5492026,242000,25,640,480,218664,0.988
473,"h264",320,240,164017,25,198,10924,704,11826,1419320,8047423,9697521,539000,15,176,144,220900,3.016
391.08,"h264",640,480,230847,25,209,9569,0,9778,9023743,2261252,11284995,242000,29.97,480,360,219480,1.232
42.2,"h264",480,360,288705,25,23,1033,0,1056,216154,1306770,1522924,5000000,25,320,240,216820,5.672
42.2,"h264",480,360,288705,25,23,1033,0,1056,216154,1306770,1522924,539000,12,480,360,216820,0.824
157.891,"h264",480,360,406908,29,87,4646,0,4733,1776729,6254165,8030894,3000000,24,480,360,219464,5.24
189.956,"flv",320,240,231296,29,97,5597,0,5694,580292,4911734,5492026,109000,15,320,240,218192,1.424
64.933,"flv",320,240,236793,15,39,936,0,975,318954,1603007,1921961,820000,15,640,480,217080,14.277
273.816,"vp8",1920,1080,1571003,25.065933,77,6766,0,6843,6190779,47579961,53770740,109000,25,640,480,219656,6.704
391.08,"h264",640,480,230847,25,209,9569,0,9778,9023743,2261252,11284995,109000,25,1280,720,219480,7.944
69.93833,"mpeg4",176,144,56717,12,14,825,0,839,47521,448322,495843,56000,25,176,144,221152,0.276
157.80167,"h264",1280,720,2885589,25,72,3873,0,3945,5611970,51306874,56918844,539000,24,176,144,216020,4.072
222.53334,"h264",480,360,500449,30,219,6457,0,6676,2821722,11099102,13920824,3000000,25,1280,720,325328,53.959
452.689,"vp8",320,240,66680,5.7057524,42,2537,0,2579,207037,3566163,3773200,3000000,29.97,640,480,255820,29.322
452.689,"vp8",320,240,66680,5.7057524,42,2537,0,2579,207037,3566163,3773200,820000,12,640,480,248752,1.024
157.891,"h264",480,360,406908,29,87,4646,0,4733,1776729,6254165,8030894,56000,24,1920,1080,219464,12.081
43.827,"flv",320,240,272273,25,23,1081,0,1104,137210,1354404,1491614,109000,29.97,1280,720,296704,26.958
189.956,"flv",320,240,231296,29,97,5597,0,5694,580292,4911734,5492026,820000,24,1280,720,218664,2.408
645.84,"vp8",320,240,95903,25.032558,138,16008,0,16146,1081321,6660941,7742262,3000000,12,1280,720,218932,5.036
290.01666,"mpeg4",176,144,52783,12,61,3417,0,3478,119325,1794184,1913509,5000000,12,480,360,129576,1.588
1140.349,"vp8",1280,720,2394626,30.007017,328,33880,0,34208,20478926,320859863,341338789,539000,24,640,480,219480,4.472
290.01666,"mpeg4",176,144,52783,12,61,3417,0,3478,119325,1794184,1913509,242000,12,176,144,125680,0.604
273.816,"vp8",1920,1080,1571003,25.065933,77,6766,0,6843,6190779,47579961,53770740,242000,12,1920,1080,219656,8.913
86.486,"h264",640,480,356037,29,46,2547,0,2593,819680,3029350,3849030,56000,15,176,144,219656,1.876
127.221664,"h264",1920,1080,3080852,23,70,2980,0,3050,3818903,45174992,48993895,539000,29.97,1280,720,394484,50.631
217.518,"h264",480,360,83054,29,112,6408,0,6520,406683,1851539,2258222,109000,29.97,480,360,217080,6.16
86.486,"h264",640,480,356037,29,46,2547,0,2593,819680,3029350,3849030,3000000,12,320,240,219656,2.176
163.897,"flv",320,240,267032,29,87,4826,0,4913,824159,4646573,5470732,56000,24,480,360,219656,4.492
225.08,"h264",480,360,538452,25,113,5515,0,5628,1873408,13275961,15149369,820000,15,480,360,216820,3.984
256.20834,"mpeg4",176,144,57565,12,56,3018,0,3074,302900,1540700,1843600,5000000,25,1280,720,219480,6.02
163.897,"flv",320,240,267032,29,87,4826,0,4913,824159,4646573,5470732,3000000,15,480,360,219656,3.668
86.486,"h264",640,480,356037,29,46,2547,0,2593,819680,3029350,3849030,5000000,15,1920,1080,219656,20.489
127.221664,"h264",1920,1080,3080852,23,70,2980,0,3050,3818903,45174992,48993895,3000000,24,1920,1080,217544,9.553
131.76,"vp8",640,480,104723,25.145039,37,3257,0,3294,945865,778937,1724802,820000,25,176,144,221152,1.68
69.933,"flv",320,240,272898,15,37,1013,0,1050,349781,2035796,2385577,820000,24,176,144,219656,1.364
98.683334,"mpeg4",176,144,55552,12,20,1164,0,1184,48267,636993,685260,5000000,25,176,144,218192,1.268
255.28,"flv",320,240,250276,25,110,6272,0,6382,611474,7374864,7986338,820000,12,1280,720,216820,3.912
49.178333,"mpeg4",176,144,54338,7,10,334,0,344,33046,300986,334032,242000,24,320,240,221160,2.944
77.233,"h264",480,360,382461,30,53,2265,0,2318,182297,3510033,3692330,820000,29.97,320,240,219480,1.248
270.655,"vp8",640,480,652967,30.062963,89,8028,0,8117,1912240,20178890,22091130,539000,24,320,240,219480,8.369
222.53334,"h264",480,360,500449,30,219,6457,0,6676,2821722,11099102,13920824,56000,15,176,144,217348,0.916
750.433,"vp8",1280,720,794075,13.482667,81,10031,0,10112,3852576,70635013,74487589,820000,29.97,176,144,165700,3.428
43.827,"flv",320,240,272273,25,23,1081,0,1104,137210,1354404,1491614,242000,29.97,1280,720,218932,11.705
107.443,"vp8",480,360,320011,30.093458,30,3190,0,3220,671936,3625932,4297868,242000,29.97,176,144,216820,2.412
292.092,"h264",480,360,480125,29,156,8599,0,8755,2375028,15155062,17530090,820000,15,320,240,219480,2.608
86.486,"h264",640,480,356037,29,46,2547,0,2593,819680,3029350,3849030,820000,15,640,480,219656,4.252
581.233,"h264",480,360,295979,30,310,17128,0,17438,10151572,11352574,21504146,109000,12,320,240,218932,3.084
255.28,"flv",320,240,250276,25,110,6272,0,6382,611474,7374864,7986338,109000,12,1920,1080,216820,3.628
368.32,"vp8",640,480,29096,25.02174,74,9134,0,9208,869558,470067,1339625,5000000,29.97,320,240,221152,0.808
379.32,"h264",480,360,181960,25,195,9289,0,9484,3392479,5235193,8627672,56000,25,176,144,219464,2.16
225.08,"h264",480,360,538452,25,113,5515,0,5628,1873408,13275961,15149369,539000,15,176,144,216820,1.712
42.2,"h264",480,360,288705,25,23,1033,0,1056,216154,1306770,1522924,5000000,24,640,480,216820,17.645
216.55,"h264",320,240,291150,29,112,6379,0,6491,1789334,6091735,7881069,539000,12,320,240,194280,2.008
217.518,"h264",480,360,83054,29,112,6408,0,6520,406683,1851539,2258222,242000,29.97,480,360,216820,3.38
273.816,"vp8",1920,1080,1571003,25.065933,77,6766,0,6843,6190779,47579961,53770740,242000,24,1920,1080,91696,8.173
860.056,"vp8",1280,720,2688309,29.968605,277,25496,0,25773,12989828,276022270,289012098,109000,12,480,360,261508,9.505
250.017,"h264",320,240,153059,29,128,7366,0,7494,856855,3926589,4783444,3000000,15,640,480,218664,4.132
43.827,"flv",320,240,272273,25,23,1081,0,1104,137210,1354404,1491614,3000000,15,176,144,218932,1.304
176.901,"vp8",480,360,26968,25.113636,38,4382,0,4420,393395,202954,596349,242000,12,640,480,218932,2.172
458.625,"h264",640,480,517364,29,245,13501,0,13746,5308581,24350943,29659524,56000,29.97,1280,720,338620,18.917
59.883,"vp8",1280,720,994960,30.38983,13,1780,0,1793,481774,6965881,7447655,539000,15,320,240,155028,4.372
368.32,"vp8",640,480,29096,25.02174,74,9134,0,9208,869558,470067,1339625,539000,24,640,480,221152,0.976
222.53334,"h264",480,360,500449,30,219,6457,0,6676,2821722,11099102,13920824,539000,12,320,240,217336,1.52
452.689,"vp8",320,240,66680,5.7057524,42,2537,0,2579,207037,3566163,3773200,242000,12,176,144,248092,1.88
339.667,"h264",640,480,257699,30,181,10010,0,10191,10121223,820261,10941484,3000000,29.97,1920,1080,219480,6.232
130.35667,"mpeg4",176,144,54590,12,27,1537,0,1564,64483,825054,889537,109000,12,320,240,50068,0.4
80.536,"h264",480,360,690041,29,43,2374,0,2417,618732,6327913,6946645,820000,12,1920,1080,651764,60.16
49.178333,"mpeg4",176,144,54338,7,10,334,0,344,33046,300986,334032,539000,24,1280,720,317452,23.941
80.536,"h264",480,360,690041,29,43,2374,0,2417,618732,6327913,6946645,539000,24,176,144,219480,3.044
74.535,"mpeg4",176,144,55305,12,15,879,0,894,23996,491276,515272,820000,12,1920,1080,219464,2.652
452.689,"vp8",320,240,66680,5.7057524,42,2537,0,2579,207037,3566163,3773200,109000,12,1280,720,248092,1.796
110.966995,"h264",480,360,397112,30,59,3271,0,3330,529627,4978664,5508291,539000,15,320,240,216820,1.112
581.233,"h264",480,360,295979,30,310,17128,0,17438,10151572,11352574,21504146,109000,29.97,480,360,218932,3.852
458.625,"h264",640,480,517364,29,245,13501,0,13746,5308581,24350943,29659524,56000,29.97,480,360,216820,4.18
440.967,"h264",320,240,281642,30,236,12994,0,13230,2444863,13079542,15524405,3000000,12,320,240,219656,3.02
391.08,"h264",640,480,230847,25,209,9569,0,9778,9023743,2261252,11284995,109000,15,1280,720,219480,2.116
128.68333,"mpeg4",176,144,55951,12,26,1518,0,1544,228020,671991,900011,242000,15,1920,1080,634052,27.294
222.53334,"h264",480,360,500449,30,219,6457,0,6676,2821722,11099102,13920824,820000,15,1920,1080,217336,27.114
385.052,"vp8",1280,720,441862,23.979221,77,9155,0,9232,16244376,5023129,21267505,5000000,24,320,240,219480,1.496
95.462,"h264",640,480,809256,29,51,2811,0,2862,886496,8770159,9656655,109000,29.97,1280,720,221160,20.213
203.198,"flv",320,240,239336,29,104,5974,0,6078,853613,5225468,6079081,109000,25,320,240,221160,3.128
286.995,"h264",480,360,508160,23,156,6726,0,6882,2285153,15944803,18229956,5000000,25,480,360,216820,1.5
163.897,"flv",320,240,267032,29,87,4826,0,4913,824159,4646573,5470732,539000,24,1280,720,219656,16.909
1388.233,"h264",480,360,388897,30,741,40907,0,41648,19358447,48126515,67484962,3000000,12,1920,1080,113912,7.98
255.28,"flv",320,240,250276,25,110,6272,0,6382,611474,7374864,7986338,3000000,25,1920,1080,216820,14.737
204.938,"h264",480,360,297373,16,111,3169,0,3280,1451634,6166260,7617894,820000,24,1920,1080,89700,3.548
250.017,"h264",320,240,153059,29,128,7366,0,7494,856855,3926589,4783444,5000000,12,480,360,218932,11.933
110.966995,"h264",480,360,397112,30,59,3271,0,3330,529627,4978664,5508291,3000000,15,480,360,216820,16.201
98.683334,"mpeg4",176,144,55552,12,20,1164,0,1184,48267,636993,685260,539000,15,1280,720,217880,1.132
69.93833,"mpeg4",176,144,56717,12,14,825,0,839,47521,448322,495843,109000,29.97,1920,1080,221152,16.045
225.08,"h264",480,360,538452,25,113,5515,0,5628,1873408,13275961,15149369,5000000,25,320,240,216820,1.092
157.80167,"h264",1280,720,2885589,25,72,3873,0,3945,5611970,51306874,56918844,5000000,15,1920,1080,216064,6.924
127.221664,"h264",1920,1080,3080852,23,70,2980,0,3050,3818903,45174992,48993895,5000000,25,1280,720,217348,12.477
52.68,"h264",480,360,372001,25,53,1265,0,1318,870136,1579497,2449633,3000000,15,480,360,140080,6.444
395.44,"vp8",1280,720,1611942,25.027847,80,9806,0,9886,5073258,74605061,79678319,820000,15,176,144,221160,1.932
270.655,"vp8",640,480,652967,30.062963,89,8028,0,8117,1912240,20178890,22091130,56000,24,176,144,219480,1.592
157.891,"h264",480,360,406908,29,87,4646,0,4733,1776729,6254165,8030894,539000,15,1920,1080,219464,4.324
157.80167,"h264",1280,720,2885589,25,72,3873,0,3945,5611970,51306874,56918844,56000,25,480,360,216064,8.881
64.933,"flv",320,240,236793,15,39,936,0,975,318954,1603007,1921961,56000,25,480,360,217080,3.28
286.995,"h264",480,360,508160,23,156,6726,0,6882,2285153,15944803,18229956,3000000,25,640,480,216820,6.84
311.1,"mpeg4",176,144,56416,12,113,3620,0,3733,127552,2066350,2193902,5000000,29.97,176,144,221160,0.676
69.93833,"mpeg4",176,144,56717,12,14,825,0,839,47521,448322,495843,820000,12,320,240,221152,1.72
239.14166,"h264",480,360,500198,25,110,5868,0,5978,1406751,13545526,14952277,820000,15,1920,1080,113556,4.456
391.08,"h264",640,480,230847,25,209,9569,0,9778,9023743,2261252,11284995,56000,24,1280,720,219480,14.317
290.01666,"mpeg4",176,144,52783,12,61,3417,0,3478,119325,1794184,1913509,820000,24,640,480,128636,2.672
273.816,"vp8",1920,1080,1571003,25.065933,77,6766,0,6843,6190779,47579961,53770740,109000,24,1920,1080,219656,38.406
906.5983,"mpeg4",176,144,56108,12,187,10692,0,10879,597549,5760936,6358485,820000,29.97,1920,1080,165668,13.509
189.956,"flv",320,240,231296,29,97,5597,0,5694,580292,4911734,5492026,56000,24,640,480,218664,0.956
282.56,"h264",640,480,559834,25,145,6920,0,7065,4966509,14806840,19773349,539000,15,1920,1080,221152,3.976
254.922,"vp8",480,360,260667,30.062992,51,7585,0,7636,918325,7387906,8306231,3000000,12,640,480,221160,20.777
395.44,"vp8",1280,720,1611942,25.027847,80,9806,0,9886,5073258,74605061,79678319,109000,29.97,1920,1080,221160,5.524
95.462,"h264",640,480,809256,29,51,2811,0,2862,886496,8770159,9656655,5000000,25,176,144,221160,3.296
714.371,"vp8",1280,720,652356,29.981792,143,21264,0,21407,14532530,43720516,58253046,3000000,29.97,1920,1080,680816,133.68
340.424,"flv",320,240,244491,11,69,4012,0,4081,1168939,9234909,10403848,820000,15,480,360,221152,0.6
282.56,"h264",640,480,559834,25,145,6920,0,7065,4966509,14806840,19773349,5000000,12,320,240,221152,1.136
239.14166,"h264",480,360,500198,25,110,5868,0,5978,1406751,13545526,14952277,5000000,12,480,360,122752,14.729
250.017,"h264",320,240,153059,29,128,7366,0,7494,856855,3926589,4783444,3000000,15,1280,720,218900,2.576
326.58832,"h264",1920,1080,5999648,23,174,7656,0,7830,16603953,228322925,244926878,5000000,29.97,480,360,218932,35.854
282.56,"h264",640,480,559834,25,145,6920,0,7065,4966509,14806840,19773349,109000,12,1920,1080,221152,3.508
49.178333,"mpeg4",176,144,54338,7,10,334,0,344,33046,300986,334032,109000,15,1280,720,221160,4.96
106.765,"h264",1280,720,849586,25,66,2603,0,2669,4427240,6911026,11338266,56000,12,1280,720,219480,10.953
290.01666,"mpeg4",176,144,52783,12,61,3417,0,3478,119325,1794184,1913509,109000,24,176,144,138224,1.996
448.575,"vp8",1280,720,2052426,30.002232,92,13349,0,13441,9132637,105950761,115083398,242000,25,480,360,217080,11.977
426.945,"h264",1280,720,1064703,29,228,12567,0,12795,11297544,45523691,56821235,5000000,24,320,240,219480,12.649
292.092,"h264",480,360,480125,29,156,8599,0,8755,2375028,15155062,17530090,56000,24,320,240,219480,1.252
74.535,"mpeg4",176,144,55305,12,15,879,0,894,23996,491276,515272,242000,25,1920,1080,219464,2.668
326.58832,"h264",1920,1080,5999648,23,174,7656,0,7830,16603953,228322925,244926878,820000,12,1280,720,218932,8.841
384.451,"h264",640,480,646432,29,205,11318,0,11523,2839955,28225248,31065203,5000000,25,480,360,217568,4.94
216.55,"h264",320,240,291150,29,112,6379,0,6491,1789334,6091735,7881069,3000000,12,1280,720,208572,2.3
86.486,"h264",640,480,356037,29,46,2547,0,2593,819680,3029350,3849030,5000000,25,176,144,219656,3.16
426.945,"h264",1280,720,1064703,29,228,12567,0,12795,11297544,45523691,56821235,5000000,25,320,240,219480,12.717
80.536,"h264",480,360,690041,29,43,2374,0,2417,618732,6327913,6946645,820000,24,1280,720,329316,52.779
106.765,"h264",1280,720,849586,25,66,2603,0,2669,4427240,6911026,11338266,820000,12,176,144,219480,3.688
645.84,"vp8",320,240,95903,25.032558,138,16008,0,16146,1081321,6660941,7742262,539000,29.97,640,480,218932,5.184
274.541,"vp8",480,360,139791,30.029198,58,8170,0,8228,802625,3994697,4797322,242000,15,480,360,216820,0.82
458.625,"h264",640,480,517364,29,245,13501,0,13746,5308581,24350943,29659524,5000000,12,176,144,216820,2.092
906.5983,"mpeg4",176,144,56108,12,187,10692,0,10879,597549,5760936,6358485,3000000,24,640,480,165668,3.204
476.957,"vp8",1280,720,1387100,30.05252,105,14200,0,14305,3487520,79210885,82698405,242000,15,480,360,165668,3.82
714.371,"vp8",1280,720,652356,29.981792,143,21264,0,21407,14532530,43720516,58253046,820000,24,320,240,164736,4.364
384.451,"h264",640,480,646432,29,205,11318,0,11523,2839955,28225248,31065203,5000000,25,176,144,217852,5.488
256.20834,"mpeg4",176,144,57565,12,56,3018,0,3074,302900,1540700,1843600,820000,24,320,240,219480,0.392
64.933,"flv",320,240,236793,15,39,936,0,975,318954,1603007,1921961,56000,12,320,240,217080,1.232
270.655,"vp8",640,480,652967,30.062963,89,8028,0,8117,1912240,20178890,22091130,109000,15,320,240,219480,4.936
286.995,"h264",480,360,508160,23,156,6726,0,6882,2285153,15944803,18229956,56000,15,640,480,216820,2.956
106.765,"h264",1280,720,849586,25,66,2603,0,2669,4427240,6911026,11338266,539000,24,1920,1080,219480,6.308
176.901,"vp8",480,360,26968,25.113636,38,4382,0,4420,393395,202954,596349,5000000,25,320,240,218932,2.02
339.667,"h264",640,480,257699,30,181,10010,0,10191,10121223,820261,10941484,820000,29.97,320,240,219480,3.636
69.933,"flv",320,240,272898,15,37,1013,0,1050,349781,2035796,2385577,5000000,24,176,144,219656,1.468
